AdvancedSearchTooltip: コンテンツフィルタを選択します
AdvancedSearch: 高度な検索

BreadcrumbsProductDocumentationHome: ホーム製品ドキュメント
BreadcrumbsSearch: 検索

Cancel: Annuler
Close: Fermer

DeleteText: 削除

ErrorOccured: エラーが発生しました
FilterUsers: フィルタユーザー：

FoundationLoginOnly: ログオン
FoundationLoginRegister: /登録ログオン

HandlerAdminOnlyAdmin: アクセスが拒否されました
HandlerBundlePageAltCSHResult: 代替CSHトピックが見つかりました
HandlerCategoriesCategoryXMLFileUploaded: カテゴリーのXMLファイルをアップロード
HandlerClassificationUpdated: 分類マップは更新します
HandlerClassificationXMLFile: 更新分類マップ
HandlerCommentsComments: コメント
HandlerCommentsOneComment: 1コメント
HandlerCommentsPostedCommentOn: コメントを上に掲載：
HandlerContentRolesAreYouSureDelete: あなたはこのコンテンツの役割を削除してもよろしいですか？
HandlerContentRolesCRDeleted: コンテンツの役割を削除します
HandlerContentRolesErrorDeleting: 問題が発生しました。コンテンツの役割は削除されませんでした。
HandlerCshAlternateCSHTopicFound: 代替CSHトピックが見つかりました。
HandlerCshCSHRulesUpdated: CSHルールの更新
HandlerCshInvalidAliases: で発見無効なエイリアスキー URL CSH
HandlerCshInvalidCSHRulesFile: 無効なCSHルールファイル
HandlerCshNewCshFile: アップロード新しいCSH設定ファイル
HandlerCshReservedAliasesUsed: 設定ファイルで使用される予約別名 CSH

HandlerCustomError400H2: 400
HandlerCustomError400H3: 不正な要求
HandlerCustomError401H2: 401
HandlerCustomError401H3: 承認
HandlerCustomError403H2: 403
HandlerCustomError403H3: 禁断
HandlerCustomError404H2: 404
HandlerCustomError404H3: 見つかりません
HandlerCustomError405H2: 405
HandlerCustomError405H3: メソッドは許可されていません
HandlerCustomError500H2: 500
HandlerCustomError500H3: 内部サーバーエラー
HandlerFontoDocumentSaved: ドキュメントを保存
HandlerFontoErrorGeneratingUUID: エラー発生UUID
HandlerFontoErrorParsingID: 解析エラーID
HandlerFontoErrorParsingXMLToDocument: エラーがドキュメントにXMLの解析
HandlerFontoErrorParsingXML: エラーXML解析
HandlerFontoNoFileFound: ファイルが見つかりません
HandlerFontoNoIDFound: IDが見つかりません。
HandlerFontoUntitledFromCursor: 無題 - カーソルから
HandlerGroupsErrorReadingGroupID: 読み取りエラーグループID
HandlerGroupsGroupUpdated: グループ更新します
HandlerGroupsMustUseUniqueGroupName: 一意のグループ名を使用する必要があります
HandlerGroupsNoGroupNameFound: が見つかりませんグループ名
HandlerGroupsUnableAssignRole: 役割を割り当てることができません。
HandlerHowtoContent: コンテンツ
HandlerHowtoDeleted: 記事の削除
HandlerHowtoInsufficientPermissions: この記事を編集する権限が不十分
HandlerHowtoSaved: 保存されました
HandlerHowtoTitle: タイトル
HandlerHtmlEmptyMyDocs: 空mydocsと
HandlerLangDefaultLanguageCodeFileUpdated: 更新されたデフォルトの言語コードファイル
HandlerLangNewLangFile: アップロード新しいデフォルトの言語コードファイル
HandlerMyPubSourcePublication: ソース公開
HandlerProfileDisplayName: 表示名
HandlerProfileScreenName: スクリーン名
HandlerProfileUpdated: 更新されたプロファイル
HandlerProfileUsernameInUse: ユーザー名が存在します
HandlerRatingsInvalidRating: 無効な評価
HandlerRatingsRatingRecorded: あなたの評価が記録されています
HandlerRatingsRatingUpdated: あなたの評価が更新されました
HandlerRolesErrorReadingRoleID: 読み取りエラーロールID
HandlerRolesMustUseUniqueRoleName: 独自の役割名を使用します
HandlerRolesNoRoleNameFound: いいえ役割名が見つかりませんでした
HandlerRolesNotEnoughAdminUsersRemaining: ユーザーを割り当てることができません。
HandlerRolesSelectedPermissionsLessThenDefault: 権限を割り当てることができません：選択した権限は、既定のアクセス許可セット未満であります
HandlerSearchAllResults: すべての結果
HandlerSearchNoResults: いいえ結果
HandlerSearchOneResult: One結果
HandlerSitemapFileUploaded: 正常にサイトマップを更新しました。
HandlerSitemapFile: サイトマップファイル
HandlerSubjectSchemeInvalidSubjectSchemeLocalizationFile: 無効な件名スキームローカライゼーション・ファイル
HandlerSubjectSchemeLangDeleted lang@Text: #{lang} 削除されたローカライズファイル
HandlerSubjectSchemeLangUpdated lang@Text: #{lang} 更新ローカリゼーションファイル
HandlerSubjectSchemeLangUploaded lang@Text: #{lang} アップロードローカライゼーション・ファイル
HandlerSubjectSchemeLangsAvailable: 利用可能な言語
HandlerSubjectSchemeLangsDeleteConfirm: あなたは、ローカリゼーションファイルを削除してもよろしいですか？
HandlerSubjectSchemeLangsDeleteError: エラーローカリゼーションファイルを削除します。
HandlerSubjectSchemeLangsNewFile: アップロード新しいSubjectSchemeローカライズファイル
HandlerSubjectSchemeProblemOccurredWhileUploadingSubjectScheme: は：件名スキームをアップロード中に問題が発生しました。
HandlerSubjectSchemeSubjectSchemeUploadedSuccessfully: 件名スキームが正常にアップロード
HandlerSubjectSchemeUnknownLanguageCode: 不明な言語コード
HandlerSubjectSchemeUpdated: 件名スキームを更新します
HandlerSubjectSchemeXMLFile: 件名スキームXMLファイル
HandlerUploadBundleBundle: バンドル
HandlerUploadBundleDeleteError x@Text: のx @テキスト：エラーを削除 #{x}
HandlerUploadBundleDeleteSuccess x@Text: @テキスト：正常に削除されました #{x}
HandlerUploadBundleErrorPleaseUpdateSuiteBundleVersion: エラー - あなたのバンドルのバージョンを更新してください
HandlerUploadBundleError: エラー
HandlerUploadBundleNoContentToDelete x@Text: ののx @テキスト： #{x} で削除することはありませんコンテンツ
HandlerUploadBundleOneBundleError: エラー移入アップロードされたバンドル
HandlerUploadBundlePublicationUploadedSuccessfully: パブリケーションが正常にアップロード
HandlerUploadBundleSheaf: 束
HandlerUsersAddedSuccess: ユーザーが正常に追加
HandlerUsersBadEmail: メールアドレスが登録されていないと
HandlerUsersCRCreated: コンテンツ役割グループを作成
HandlerUsersCRGroupNameInUse: コンテンツロール名は既に使用されています
HandlerUsersCRSetGroupName: このコンテンツ役割グループの名前を設定してください
HandlerUsersCRUpdated: コンテンツ役割グループ更新
HandlerUsersDefineCR: 新しいコンテンツ役割グループを定義します。
HandlerUsersDeleteSuccess: 削除されたユーザーに成功
HandlerUsersEmailError: エラーは、パスワードのリセットメールを送信します
HandlerUsersInvalidToken: 無効なトークン
HandlerUsersNoResetToken: いいえリセットトークン
HandlerUsersNoRoleIdFound: いいえロールIDが見つかりませんでした
HandlerUsersPasswordEmailSent: パスワードリセットのメールが送信されました
HandlerUsersRegisterSuccess: 登録ユーザー正常に
HandlerUsersResetPasswordError: エラーリセットパスワード
HandlerUsersRolesUpdated: ユーザの役割は、更新します
HandlerUsersUnableToAssignUserPermissionRole: ユー​​ザー権限の役割を割り当てることができません。
HandlerUsersUnknownError: 不明なエラー
HideTOC: 目次を隠す表
ImportAddHelperProblemRunningAddHelper: 問題実行中はaddHelper
ImportBundlesTooManyTopics num@Int: #{show num} トピックの最大を公開することができます。少ないのトピックを選択して、もう一度お試しください。
ImportElasticAnalyzerError: - 注：カスタム・アナライザのエラー、詳細についてはログを参照してください。デフォルトのアナライザを使用します。
ImportElasticErrorRebuilding: エラー再構築インデックス - 詳細はログを参照してください。
ImportElasticErrorUpdating: エラーの更新インデックス - 詳細はログを参照してください。
ImportElasticIndexRebuilt x@Text: インデックス正常に再構築 #{x}
ImportElasticIndexUpdated x@Text: インデックスが正常に更新 #{x}
ImportElasticNoPagesFound: データベースが見つかりませんページ - インデックスのリセット。
ImportElasticNoPagesInBundle: アップロードが見つかりませんページ
ImportInvalidPassword: 無効なパスワード
ImportRatingsOneRating: 1評価
ImportRatingsRatings: 評価
ImportRolesPermissionDenied: アクセス許可は拒否されました
ImportSearchNoCategoriesUploaded: いいえカテゴリーXMLファイルがアップロードされていません
ImportSearchUnknownTopicLink: ***不明のトピックリンク***
ImportUsersCaptchaError: 無効reCAPTCHAの
ImportUsersCaptchaParseError: reCAPTCHAのエラー
ImportUsersEmailFieldError: いいえ電子メールフィールドが見つかりませんでした。
ImportUsersFldEmail: メール
ImportUsersFldFirstName: ファーストネーム
ImportUsersFldLastName: 姓
ImportUsersFldPassword: パスワード
ImportUsersFldReenterPass: パスワードを再入力してください
ImportUsersInvalidPass: 無効なパスワード：選択したパスワードは、少なくとも1大文字、1小文字、1特殊文字、および1個を含む少なくとも8文字でなければなりません。
LoggedInAs email@Text: #{email} として記録されます。
PDFPage: ページ
ProductDocumentationSplashTitle: 製品ドキュメント
PublishHowto: 公開
ResultsPerPageShow: ページあたりの表示XX
ResultsPerPage: ページあたりの検索結果
SSOLoginParamError: はSSOログイン・パラメータを使用してエラーが発生しました
SSOLoginTryAgain: 付きで再度ログインしてみてください
SearchContent: このコンテンツを検索
SearchHome: 検索製品マニュアル
ShowTOC: 内容のテーブルの表示
SwitchLang: 言語の変更
TemplTemplateBundlePageProvideFeedbackTooltip: フィードバックを送信
TemplaesBundlesTitle: ドキュメント・ライブラリ
TemplateAddHelperCancel: キャンセル
TemplateAddHelperSaveAndClose: 保存して閉じます
TemplateAddHelperSave: 保存
TemplateAddUserAddUser: ユーザーの追加
TemplateAddUserCancel: キャンセル
TemplateAddUserPasswordMessage: パスワードは少なくとも1大文字、1小文字、1特殊文字、および1個を含む少なくとも8文字でなければなりません。
TemplateAdminArticleManagement: 記事の管理
TemplateAdminCSHConfigFile: CSHコンフィギュレーションファイルをダウンロードまたは更新
TemplateAdminContentRoleGroups: コンテンツ役割グループ
TemplateAdminElasticReindex: 検索インデックスを再構築
TemplateAdminExportComments: 輸出コメント
TemplateAdminExportRatings: 輸出評価
TemplateAdminManageManuals: 管理マニュアル
TemplateAdminManageResourceManuals: リソースパッケージの管理
TemplateAdminResourceIdCsv: ResourceIds Excelファイルをダウンロード
TemplateAdminSitemap: サイトマップを管理します
TemplateAdminSubjectSchemeLocalization: 件名スキームのローカライズを管理します
TemplateAdminTitle: 管理
TemplateAdminUploadCategoryXML: カテゴリーXMLファイルを管理します
TemplateAdminUploadCategoryXml: 新しいカテゴリーのXMLファイルをアップロード
TemplateAdminUploadNewLangFile: 新しいデフォルトのLangugeコードファイルをアップロード
TemplateAdminUploadSubjectScheme: 件名スキームを管理します
TemplateAdminUserGroups: ユーザグループ
TemplateAdminUserManagement: ユーザー管理
TemplateAdminUserRoles: ユーザの役割
TemplateBundlePageCollapseTooltip:すべてのタイトルを折りたたみます
TemplateBundlePageCollapse: 折りたたみ
TemplateBundlePageComments: コメント
TemplateBundlePageContents: 目次
TemplateBundlePageExpandTooltip: 目次を展開
TemplateBundlePageExpand: 展開
TemplateBundlePageFeedbackThankYou: ありがとう！あなたのご意見を送られました。
TemplateBundlePageFeedbackTooltip: フィードバックを送信
TemplateBundlePageFeedback: フィードバック
TemplateBundlePageFilterTitle: 1つ以上のオプションを選択します
TemplateBundlePageNextTopicTooltip: 次のトピックに移動します
TemplateBundlePageNext: 次
TemplateBundlePageNo: いいえ
TemplateBundlePagePrevTopicTooltip: 前のトピックに移動します
TemplateBundlePagePrevious: 前
TemplateBundlePagePrintTooltip: トピックの印刷
TemplateBundlePagePrint: 印刷
TemplateBundlePagePrivacy: あなたのプライバシーを保護するためには、あなたのフィードバックの連絡先情報が含まれていません。当社のプライバシーポリシーを確認します。
TemplateBundlePageProvideFeedbackTooltip: フィードバックの提供
TemplateBundlePageSaveAsPDF: PDFとして保存
TemplateBundlePageSavePDFTooltip: PDFとして保存
TemplateBundlePageSaveSelectedTopicAndSubtopics: 選択したトピックとサブトピックを保存
TemplateBundlePageSaveSelectedTopic: 選択したトピックを保存
TemplateBundlePageSeeAlso: も参照してください。
TemplateBundlePageSendLinkTooltip: トピックへのリンクを送信
TemplateBundlePageSendLink: 送ります
TemplateBundlePageSend: 送ります
TemplateBundlePageSubmit: 提出
TemplateBundlePageWasThisInformationHelpful: この情報は役に立ちましたか？
TemplateBundlePageYEs: はい
TemplateBundlesDeleteLanguage: 言語を削除します。
TemplateBundlesDeleteManual: 手動の削除
TemplateBundlesDownloadClassification: 分類XMLをダウンロード
TemplateBundlesDownload: ダウンロードバンドル
TemplateBundlesHiddenBundle: 隠しマニュアル
TemplateBundlesSearchManuals: 検索マニュアル
TemplateBundlesUploadClassification: アップロード分類XML
TemplateClassificationForManual: マニュアルについて
TemplateClassificationUploadClassificationMap: アップロード分類地図XML
TemplateClassificationWarnReindex: 注：分類地図のアップロードサイト全体を再インデックス付けされます。ちょっと時間かかります。
TemplateContentRolesCRGroups: コンテンツ役割グループ
TemplateContentRolesDefineNewCR: 新規コンテンツの役割を定義します
TemplateDefaultLayoutAdministration: 管理
TemplateDefaultLayoutArticles: 記事
TemplateDefaultLayoutBrowseDocumentation: ブラウズ
TemplateDefaultLayoutDocumentation: ドキュメント・ライブラリ
TemplateDefaultLayoutHome: ホーム
TemplateDefaultLayoutLanguages: ​：アメリカ合衆国 - 英語
TemplateDefaultLayoutLinksCareers: 採用情報
TemplateDefaultLayoutLinksContactUs: お問い合わせ
TemplateDefaultLayoutLinksIntelCorp: インテルコーポレーション©
TemplateDefaultLayoutLinksLegalContractsandTerms: 法的契約および利用規約
TemplateDefaultLayoutLinksLegalNotices: 法的通知
TemplateDefaultLayoutLinksSiteMap: サイトマップ
TemplateDefaultLayoutLinksWebsiteFeedback: ウェブサイトのフィードバック
TemplateDefaultLayoutLogout: サインアウト
TemplateDefaultLayoutProfile: プロフィール
TemplateDefaultLayoutVideos: ビデオ
TemplateFilterCurrentPublication: 現在の公報
TemplateRequestResetPasswordEmail: メール
TemplateRequestResetPasswordSubmit: パスワードリセットのメールをリクエスト
TemplateSearchCurrentPublication name@Text: 現在の検索条件は、 '#{name}'出版物に限定されています
TemplateSearchPageClearTooltip: クリアフィルター
TemplateSearchPageFirstPageTooltip: 最初のページに移動します
TemplateSearchPageLastPageTooltip: 最後のページへ
TemplateSearchPageNextPageTooltip: 次のページに移動します
TemplateSearchPagePrevPageTooltip: 前のページに戻ります
TemplateSearchPublicationTitle: 出版
TemplateSearchSortbyCreatedAsc: 作成日 - 昇順
TemplateSearchSortbyCreatedDec: 作成日 - 降順
TemplateSearchSortbyScore: スコア
TemplateSearchSortbyUpdatedAsc: 登録日 - 昇順
TemplateSearchSortbyUpdatedDec: 登録日 - 降順
TemplateSearchSortbyViews: ビューの数
TemplateUploadSitemapDisabledWord: 無効
TemplateUploadSitemapDisabled: サイトマップは無効
TemplateUploadSitemapDisable: 無効サイトマップ
TemplateUploadSitemapDownloadSitemap: ダウンロードsitemap.xmlと
TemplateUploadSitemapEnabledWord: 有効
TemplateUploadSitemapEnabled: サイトマップが有効
TemplateUploadSitemapEnable: サイトマップを有効にします
TemplateUploadSitemapLegend: アップロードsitemap.xmlと
TemplateUploadSitemapStatus sts@Text: サイトマップは #{sts}
TemplatesSearchPageClear: クリア
TemplatesSearchPageCurrentResults: ZZZの結果XX-YY
TemplatesSearchPageRefilneResults: 絞り込み結果
TemplatesSearchPageResultUpdated: 更新
TextPass txt@Text: #{txt}

Upload: Télécharger
UploadLink: アップロード出版
YesodAuthStormPathSSOErrorOccured: エラーが発生しました
YesodAuthStormPathSSOLoginParamError: SSOログイン・パラメータを使用してエラーが発生しました
YesodAuthStormPathSSOLoginTryAgain: 付きで再度ログインしてみてください
