AdvancedSearch: Udvidet søgning 
AdvancedSearchTooltip: Vælg indholdsfiltre
BreadcrumbsProductDocumentationHome: Produktdokumentation hjem
BreadcrumbsSearch: Søg
Cancel: Annuller
Close: Luk
DeleteText: Slet
ErrorOccured: Der opstod en fejl
FilterUsers: Filtrer brugere:
FoundationLoginOnly: Log på
FoundationLoginRegister: Log på / registrer
HandlerAdminOnlyAdmin: Adgang nægtet
HandlerBundlePageAltCSHResult: Alternativt CSH-emne fundet
HandlerCategoriesCategoryXMLFileUploaded: Kategori XML-fil overført
HandlerClassificationUpdated: Klassifikationskort opdateret
HandlerClassificationXMLFile: Klassifikationskort opdateret
HandlerCommentsComments: kommentarer
HandlerCommentsOneComment: 1 kommentar
HandlerCommentsPostedCommentOn: oprettede en kommentar på:
HandlerContentRolesAreYouSureDelete: Er du sikker på, at du vil slette denne indholdsrolle?
HandlerContentRolesCRDeleted: Indholdsrolle slettet
HandlerContentRolesErrorDeleting: Der opstod et problem. Indholdsrollen blev ikke slettet
HandlerCshAlternateCSHTopicFound: Alternativt CSH-emne fundet
HandlerCshCSHRulesUpdated: CSH-regler opdateret
HandlerCshInvalidAliases: Ugyldig alias-nøgle fundet i CSH-URL
HandlerCshInvalidCSHRulesFile: Ugyldig CSH-regelfil
HandlerCshNewCshFile: Overfør ny CSH-konfigurationsfil
HandlerCshReservedAliasesUsed: Reserverede alias'er brugt i CSH-konfigurationsfil
HandlerCustomError400H2: 400
HandlerCustomError400H3: Dårlig anmodning
HandlerCustomError401H2: 401
HandlerCustomError401H3: Uautoriseret
HandlerCustomError403H2: 403
HandlerCustomError403H3: Forbudt
HandlerCustomError404H2: 404
HandlerCustomError404H3: Ikke fundet
HandlerCustomError405H2: 405
HandlerCustomError405H3: Metode ikke tilladt
HandlerCustomError500H2: 500
HandlerCustomError500H3: Intern serverfejl
HandlerFontoDocumentSaved: Dokument gemt
HandlerFontoErrorGeneratingUUID: Fejl ved oprettelse af UUID
HandlerFontoErrorParsingID: Fejl ved fortolkning af id
HandlerFontoErrorParsingXML: Fejl ved fortolkning af XML
HandlerFontoErrorParsingXMLToDocument: Fejl ved fortolkning af XML til dokument
HandlerFontoNoFileFound: Filen blev ikke fundet
HandlerFontoNoIDFound: Id blev ikke fundet
HandlerFontoUntitledFromCursor: Ikke-navngivet - fra markør
HandlerGroupsErrorReadingGroupID: Der opstod fejl under læsning af gruppe-id
HandlerGroupsGroupUpdated: Gruppe opdateret
HandlerGroupsMustUseUniqueGroupName: Skal bruge unikt gruppenavn
HandlerGroupsNoGroupNameFound: Intet gruppenavn fundet
HandlerGroupsUnableAssignRole: Kan ikke tildele rolle
HandlerHowtoContent: Indhold
HandlerHowtoDeleted: Artikel slettet
HandlerHowtoInsufficientPermissions: Utilstrækkelig tilladelse til at redigere denne artikel
HandlerHowtoSaved: Gemt
HandlerHowtoTitle: Titel
HandlerHtmlEmptyMyDocs: Tøm MyDocs
HandlerLangDefaultLanguageCodeFileUpdated: Standard sprogkodefil opdateret
HandlerLangNewLangFile: Overfør ny standard sprogkodefil
HandlerMyPubSourcePublication: Kildepublikation
HandlerProfileDisplayName: Vist navn
HandlerProfileScreenName: Skærmnavn
HandlerProfileUpdated: Profil opdateret
HandlerProfileUsernameInUse: Brugernavn findes
HandlerRatingsInvalidRating: Ugyldig klassificering
HandlerRatingsRatingRecorded: Din klassificering er blevet gemt
HandlerRatingsRatingUpdated: Din klassificering er blevet opdateret
HandlerRolesErrorReadingRoleID: Der opstod fejl under læsning af rolle-id
HandlerRolesMustUseUniqueRoleName: Brug et unikt rollenavn
HandlerRolesNoRoleNameFound: Intet rollenavn fundet
HandlerRolesNotEnoughAdminUsersRemaining: Kan ikke tildele brugere
HandlerRolesSelectedPermissionsLessThenDefault: Kan ikke tildele tilladelser: De valgte tilladelser er mindre end den indstillede standardtilladelse
HandlerSearchAllResults: Alle resultater
HandlerSearchNoResultsMsgTryFollowing: Ingen resultater fundet. Prøv følgende:
HandlerSearchNoResultsMsgSpelledCorrectly: Sørg for at alle ord er stavet korrekt.
HandlerSearchNoResultsMsgTryDifferent: Prøv forskellige søgeord.
HandlerSearchNoResultsMsgMoreGeneral: Prøv mere generelle søgeord.
HandlerSearchNoResultsMsgNoFindProdVer: Må ikke finde dit produkt eller din version? Gå til Intel Security ServicePortal.
HandlerSearchNoResults: Ingen resultater
HandlerSearchOneResult: Et resultat
HandlerSitemapFile: Fil med oversigt over websted
HandlerSitemapFileUploaded: Opdatering af oversigt over websted gennemført.
HandlerSubjectSchemeInvalidSubjectSchemeLocalizationFile: Ugyldig lokaliseringsfil for emneordning
HandlerSubjectSchemeLangDeleted lang@Text: #{lang} Slettet lokaliseringsfil
HandlerSubjectSchemeLangsAvailable: Tilgængelige sprog
HandlerSubjectSchemeLangsDeleteConfirm: Er du sikker på, at du vil slette lokaliseringsfilen? 
HandlerSubjectSchemeLangsDeleteError: Fejl ved sletning af lokaliseringsfil.
HandlerSubjectSchemeLangsNewFile: Overfør ny lokaliseringsfil for emneordning
HandlerSubjectSchemeLangUpdated lang@Text: #{lang} Opdateret lokaliseringsfil
HandlerSubjectSchemeLangUploaded lang@Text: #{lang} Overført lokaliseringsfil 
HandlerSubjectSchemeProblemOccurredWhileUploadingSubjectScheme: Der opstod et problem under overførslen af emneordningen.
HandlerSubjectSchemeSubjectSchemeUploadedSuccessfully: Overførsel af emneordningen blev gennemført
HandlerSubjectSchemeUnknownLanguageCode: Ukendt sprogkode
HandlerSubjectSchemeUpdated: Emneordning opdateret
HandlerSubjectSchemeXMLFile: Emneordning XML-fil
HandlerUploadBundleBundle: bundt
HandlerUploadBundleDeleteError x@Text: Der opstod fejl under sletning af #{x}
HandlerUploadBundleDeleteSuccess x@Text: Sletning af #{x} gennemført
HandlerUploadBundleError: Fejl
HandlerUploadBundleErrorPleaseUpdateSuiteBundleVersion: Fejl - Opdater din bundt-version
HandlerUploadBundleNoContentToDelete x@Text: Intet indhold at slette i #{x} 
HandlerUploadBundleOneBundleError: Fejl under udfyldning af overført bundt
HandlerUploadBundlePublicationUploadedSuccessfully: Overførsel af publikation gennemført
HandlerUploadBundleSheaf: sheaf
HandlerUsersAddedSuccess: Bruger tilføjet
HandlerUsersBadEmail: Den e-mailadresse er ikke registreret
HandlerUsersCRCreated: Indholdsrollegruppe oprettet
HandlerUsersCRGroupNameInUse: Indholdsrollegruppenavnet er allerede i brug
HandlerUsersCRSetGroupName: Angiv et navn for denne indholdsrollegruppe
HandlerUsersCRUpdated: Indholdsrollegruppe opdateret
HandlerUsersDefineCR: Definer ny indholdsrollegruppe
HandlerUsersDeleteSuccess: Sletning af bruger gennemført
HandlerUsersEmailError: Fejl ved sending af e-mail til nulstilling af adgangskode
HandlerUsersInvalidToken: Ugyldigt token
HandlerUsersNoResetToken: Intet nulstillingstoken
HandlerUsersNoRoleIdFound: Intet rolle-id fundet
HandlerUsersPasswordEmailSent: E-mail til nulstilling af adgangskode sendt
HandlerUsersRegisterSuccess: Registrering af bruger gennemført
HandlerUsersResetPasswordError: Fejl ved nulstilling af adgangskode
HandlerUsersRolesUpdated: Brugerroller opdateret
HandlerUsersUnableToAssignUserPermissionRole: Kan ikke tildele brugertilladelsesrolle
HandlerUsersUnknownError: Ukendt fejl
HideTOC: Skjul indholdsfortegnelse
ImportAddHelperProblemRunningAddHelper: Problem med kørsel af addHelper
ImportBundlesTooManyTopics num@Int: Der kan maksimalt publiceres #{show num} emner. Vælg færre emner og prøv igen.
ImportElasticAnalyzerError: - Bemærk: Fejl i tilpasset analyseværktøj, se loggen for oplysninger. Bruger standard-analyseværktøj. 
ImportElasticErrorRebuilding: Fejl ved genopbygning af indeks - se loggen for oplysninger.
ImportElasticErrorUpdating: Fejl ved opdatering af indeks - se loggen for oplysninger.
ImportElasticIndexRebuilt x@Text: Genopbygning af indeks gennemført #{x}
ImportElasticIndexUpdated x@Text: Opdatering af indeks gennemført #{x}
ImportElasticNoPagesFound: Ingen sider fundet i database - indeks nulstillet.
ImportElasticNoPagesInBundle: Ingen sider fundet i overførsel
ImportInvalidPassword: Ugyldig adgangskode
ImportRatingsOneRating: 1 Klassificering
ImportRatingsRatings: Klassificeringer
ImportRolesPermissionDenied: Tilladelse blev nægtet
ImportSearchNoCategoriesUploaded: Ingen kategori XML-fil overført
ImportSearchUnknownTopicLink: *** ukendt emnelink ***
ImportUsersCaptchaError: Ugyldig reCAPTCHA 
ImportUsersCaptchaParseError: reCAPTCHA fejl
ImportUsersEmailFieldError: Intet e-mail-felt fundet.
ImportUsersFldEmail: E-mail
ImportUsersFldFirstName: Fornavn
ImportUsersFldLastName: Efternavn
ImportUsersFldPassword: Adgangskode
ImportUsersFldReenterPass: Indtast adgangskode igen
ImportUsersInvalidPass: Ugyldig adgangskode: den valgte adgangskode skal være på mindst otte tegn, herunder mindst et stort bogstav, et lille bogstav, et specialtegn og et tal.
LoggedInAs email@Text: Logget ind som #{email}
Manuals: Vejledninger
PDFPage: Side
ProductDocumentationSplashTitle: Produktdokumentation 
PublishHowto: Publicer
ResultsPerPage: Resultater pr. side
ResultsPerPageShowFirst: Vis
ResultsPerPageShow: pr. side
Search: Søg i produktdokumentation
SearchContent: Søg i dette dokument
SearchHome: Søg i produktdokumentation
ShowTOC: Vis indholdsfortegnelse
SSOLoginParamError: Der var en fejl i forbindelse med SSO-loginparametrene
SSOLoginTryAgain: Prøve at logge ind igen med
SwitchLang: Skift sprog
TemplaesBundlesTitle: Dokumentationsbibliotek
TemplateAddHelperCancel: Annuller
TemplateAddHelperSave: Gem
TemplateAddHelperSaveAndClose: Gem og luk
TemplateAddUserAddUser: Tilføj bruger
TemplateAddUserCancel: Annuller
TemplateAddUserPasswordMessage: Adgangskoden skal være på mindst otte tegn, herunder mindst et stort bogstav, et lille bogstav, et specialtegn og et tal.
TemplateAdminArticleManagement: Artikeladministration
TemplateAdminContentRoleGroups: Indholdsrollegrupper
TemplateAdminCSHConfigFile: Download eller opdater CSH-konfigurationsfil
TemplateAdminElasticReindex: Genopbyg søgeindeks
TemplateAdminExportComments: Eksporter kommentarer
TemplateAdminExportRatings: Eksporter klassificering
TemplateAdminManageManuals: Administrer vejledninger
TemplateAdminManageResourceManuals: Administrer ressourcepakker
TemplateAdminResourceIdCsv: Download ResourceIds Excel-fil
TemplateAdminSitemap: Administrer oversigt over websted
TemplateAdminSubjectSchemeLocalization: Administrer lokalisering for emneordning
TemplateAdminTitle: Administration
TemplateAdminUploadCategoryXML: Administrer kategori XML-fil
TemplateAdminUploadCategoryXml: Overfør en XML-fil for ny kategori
TemplateAdminUploadNewLangFile: Overfør en ny standard sprogkodefil
TemplateAdminUploadSubjectScheme: Administrer emneordning
TemplateAdminUserGroups: Brugergrupper
TemplateAdminUserManagement: Brugeradministration
TemplateAdminUserRoles: Brugerroller
TemplateBundlePageCollapse: Skjul
TemplateBundlePageCollapseTooltip: Skjul alle titler
TemplateBundlePageComments: Kommentarer
TemplateBundlePageContents: Indhold
TemplateBundlePageExpand: Udvid
TemplateBundlePageExpandTooltip: Udvid indholdsfortegnelse
TemplateBundlePageFeedback: Feedback
TemplateBundlePageFeedbackThankYou: Tak! Dine kommentarer er blevet afsendt. 
TemplateBundlePageFeedbackTooltip: Indsend feedback
TemplateBundlePageFilterTitle: Vælg en eller flere indstillinger
TemplateBundlePageNext: Næste
TemplateBundlePageNextTopicTooltip: Gå til næste emne
TemplateBundlePageNo: Nej
TemplateBundlePagePrevious: Forrige 
TemplateBundlePagePrevTopicTooltip: Gå til forrige emne
TemplateBundlePagePrint: Udskriv
TemplateBundlePagePrintTooltip: Udskriv emne
TemplateBundlePagePrivacy: For at beskytte dine personlige oplysninger skal du ikke inkludere kontaktoplysninger i din feedback. Gennemse vores politik om
TemplateBundlePagePrivacyLast: personlige oplysninger.
TemplateBundlePageProvideFeedbackCharsLeft: tegn tilbage
TemplateBundlePageProvideFeedbackTooltip: Giv feedback
TemplateBundlePageSaveAsPDF: Gem som PDF
TemplateBundlePageSavePDFTooltip: Gem som PDF
TemplateBundlePageSaveSelectedTopic: Gem valgte emne
TemplateBundlePageSaveSelectedTopicAndSubtopics: Gem valgte emne og underemner
TemplateBundlePageSeeAlso: Se også
TemplateBundlePageSend: Send
TemplateBundlePageSendLink: Send
TemplateBundlePageSendLinkTooltip: Send link til emne
TemplateBundlePageSubmit: Indsend
TemplateBundlePageWasThisInformationHelpful: Hjalp disse oplysninger?
TemplateBundlePageYEs: Ja
TemplateBundlesDeleteLanguage: Slet sprog
TemplateBundlesDeleteManual: Slet vejledning
TemplateBundlesDownload: Download bundt
TemplateBundlesDownloadClassification: Download klassifikation XML
TemplateBundlesHiddenBundle: Skjult vejledning
TemplateBundlesSearchManuals: Søg vejledninger
TemplateBundlesUploadClassification: Overfør klassifikation XML
TemplateClassificationForManual: For manuelt
TemplateClassificationUploadClassificationMap: Overfør klassifikationskort XML
TemplateClassificationWarnReindex: Bemærk: Hele webstedet skal genindføres, hvis du overfører en klassifikationsoversigt. Dette kan tage flere minutter.
TemplateContentRolesCRGroups: Indholdsrollegrupper
TemplateContentRolesDefineNewCR: Definer ny indholdsrolle
TemplateDefaultLayoutAdministration: Administration
TemplateDefaultLayoutArticles: Artikler
TemplateDefaultLayoutBrowseDocumentation: Gennemse
TemplateDefaultLayoutDocumentation: Dokumentationsbibliotek
TemplateDefaultLayoutHome: Hjem
TemplateDefaultLayoutLanguages: United States - English
TemplateDefaultLayoutLinksCareers: Karrierer
TemplateDefaultLayoutLinksContactUs: Kontakt os
TemplateDefaultLayoutLinksIntelCorp: © Intel Corporation
TemplateDefaultLayoutLinksLegalContractsandTerms: Juridiske kontrakter og vilkår
TemplateDefaultLayoutLinksLegalNotices: Juridiske oplysninger 
TemplateDefaultLayoutLinksPrivacy: Privatliv
TemplateDefaultLayoutLinksSiteMap: Oversigt over websted
TemplateDefaultLayoutLinksWebsiteFeedback: Feedback for websted
TemplateDefaultLayoutLogout: Log af
TemplateDefaultLayoutProfile: Profil
TemplateDefaultLayoutVideos: Videoer
TemplateFilterCurrentPublication: Aktuel publikation
TemplateRequestResetPasswordEmail: E-mail
TemplateRequestResetPasswordSubmit: Anmod om e-mail til nulstilling af adgangskode
TemplateSearchCurrentPublication name@Text: Aktuel søgning er begrænset til publikationen '#{name}'
TemplateSearchPageClearTooltip: Ryd filtre
TemplateSearchPageFirstPageTooltip: Gå til den første side
TemplateSearchPageLastPageTooltip: Gå til den sidste side
TemplateSearchPageNextPageTooltip: Gå til næste side
TemplateSearchPagePrevPageTooltip: Gå til forrige side
TemplateSearchPublicationTitle: Publikation
TemplateSearchSortbyCreatedAsc: Oprettelsesdato – stigende
TemplateSearchSortbyCreatedDec: Oprettelsesdato – aftagende
TemplateSearchSortbyScore: Resultat
TemplateSearchSortbyUpdatedAsc: Dato tilføjet – stigende
TemplateSearchSortbyUpdatedDec: Dato tilføjet – aftagende
TemplateSearchSortbyViews: Antal visninger
TemplatesSearchPageClear: Ryd
TemplatesSearchPageCurrentResultsFirst: Resultater
TemplatesSearchPageCurrentResults: af
TemplatesSearchPageRefilneResults: Tilpas resultater
TemplatesSearchPageResultUpdated: Opdateret
TemplateUploadSitemapDisable: Deaktiver oversigt over websted
TemplateUploadSitemapDisabled: Oversigt over websted deaktiveret
TemplateUploadSitemapDisabledWord: Deaktiveret
TemplateUploadSitemapDownloadSitemap: Download sitemap.xml
TemplateUploadSitemapEnable: Aktiver oversigt over websted
TemplateUploadSitemapEnabled: Oversigt over websted aktiveret
TemplateUploadSitemapEnabledWord: Aktiveret
TemplateUploadSitemapLegend: Overfør sitemap.xml
TemplateUploadSitemapStatus sts@Text: Oversigt over websted er #{sts}
TextPass txt@Text: #{txt}
Upload: Overfør
UploadLink: Overfør publikation
YesodAuthStormPathSSOErrorOccured: Der opstod en fejl
YesodAuthStormPathSSOLoginParamError: Der var en fejl i forbindelse med SSO-loginparametrene
YesodAuthStormPathSSOLoginTryAgain: Prøve at logge ind igen med
