AdvancedSearch: Erweiterte Suche 
AdvancedSearchTooltip: Inhaltsfilter auswählen
BreadcrumbsProductDocumentationHome: Startseite der Produktdokumentation
BreadcrumbsSearch: Suchen
Cancel: Abbrechen
Close: Schließen
DeleteText: Löschen
ErrorOccured: Ein Fehler ist aufgetreten.
FilterUsers: Benutzer filtern:
FoundationLoginOnly: Anmelden
FoundationLoginRegister: Anmelden / Registrieren
HandlerAdminOnlyAdmin: Der Zugriff wurde verweigert.
HandlerBundlePageAltCSHResult: Alternatives CSH-Thema gefunden
HandlerCategoriesCategoryXMLFileUploaded: Kategorie-XML-Datei wurde hochgeladen.
HandlerClassificationUpdated: Klassifizierungszuordnung wurde aktualisiert
HandlerClassificationXMLFile: Klassifizierungszuordnung wurde aktualisiert.
HandlerCommentsComments: Kommentare
HandlerCommentsOneComment: 1 Kommentar
HandlerCommentsPostedCommentOn: hat ein Kommentar gepostet auf:
HandlerContentRolesAreYouSureDelete: Möchten Sie diese Inhaltsrolle wirklich löschen?
HandlerContentRolesCRDeleted: Inhaltsrolle wurde gelöscht
HandlerContentRolesErrorDeleting: Es ist ein Problem aufgetreten. Die Inhaltsrolle wurde nicht gelöscht.
HandlerCshAlternateCSHTopicFound: Alternatives CSH-Thema wurde gefunden.
HandlerCshCSHRulesUpdated: CSH-Regeln wurden aktualisiert.
HandlerCshInvalidAliases: Ungültige Alias-Schlüssel in CSH-URL gefunden
HandlerCshInvalidCSHRulesFile: CSH-Regeln-Datei ist ungültig.
HandlerCshNewCshFile: Neue CSH-Konfigurationsdatei hochladen
HandlerCshReservedAliasesUsed: Reservierte Aliase in CSH-Konfigurationsdatei verwendet
HandlerCustomError400H2: 400
HandlerCustomError400H3: Ungültige Anfrage
HandlerCustomError401H2: 401
HandlerCustomError401H3: Nicht autorisiert
HandlerCustomError403H2: 403
HandlerCustomError403H3: Nicht zulässig
HandlerCustomError404H2: 404
HandlerCustomError404H3: Nicht gefunden
HandlerCustomError405H2: 405
HandlerCustomError405H3: Methode nicht zulässig
HandlerCustomError500H2: 500
HandlerCustomError500H3: Interner Serverfehler
HandlerFontoDocumentSaved: Dokument wurde gespeichert.
HandlerFontoErrorGeneratingUUID: Fehler beim Generieren von UUID
HandlerFontoErrorParsingID: Fehler beim Analysieren der ID
HandlerFontoErrorParsingXML: Fehler beim Umwandeln der XML-Datei
HandlerFontoErrorParsingXMLToDocument: Fehler beim Umwandeln der XML-Datei in Dokument
HandlerFontoNoFileFound: Datei wurde nicht gefunden.
HandlerFontoNoIDFound: ID wurde nicht gefunden.
HandlerFontoUntitledFromCursor: Unbenannt – vom Cursor
HandlerGroupsErrorReadingGroupID: Beim Lesen der Gruppen-ID ist ein Fehler aufgetreten.
HandlerGroupsGroupUpdated: Gruppe wurde aktualisiert.
HandlerGroupsMustUseUniqueGroupName: Es muss ein eindeutiger Gruppenname verwendet werden.
HandlerGroupsNoGroupNameFound: Keinen Gruppennamen gefunden
HandlerGroupsUnableAssignRole: Zuweisen der Rolle nicht möglich
HandlerHowtoContent: Inhalt
HandlerHowtoDeleted: Artikel wurde gelöscht
HandlerHowtoInsufficientPermissions: Unzureichende Berechtigungen für die Bearbeitung dieses Artikels
HandlerHowtoSaved: Gespeichert
HandlerHowtoTitle: Titel
HandlerHtmlEmptyMyDocs: 'Meine Dokumente' leeren
HandlerLangDefaultLanguageCodeFileUpdated: Codedatei für die Standardsprache wurde aktualisiert.
HandlerLangNewLangFile: Neue Codedatei für die Standardsprache hochladen
HandlerMyPubSourcePublication: Quellpublikation
HandlerProfileDisplayName: Anzeigename
HandlerProfileScreenName: Bildschirmname
HandlerProfileUpdated: Profil wurde aktualisiert
HandlerProfileUsernameInUse: Benutzername ist bereits vorhanden.
HandlerRatingsInvalidRating: Ungültige Bewertung
HandlerRatingsRatingRecorded: Ihre Bewertung wurde aufgezeichnet.
HandlerRatingsRatingUpdated: Ihre Bewertung wurde aktualisiert
HandlerRolesErrorReadingRoleID: Beim Lesen der Rollen-ID ist ein Fehler aufgetreten.
HandlerRolesMustUseUniqueRoleName: Nutzen Sie einen eindeutigen Rollennamen
HandlerRolesNoRoleNameFound: Keinen Rollennamen gefunden
HandlerRolesNotEnoughAdminUsersRemaining: Benutzer zuweisen nicht möglich
HandlerRolesSelectedPermissionsLessThenDefault: Berechtigungen können nicht zugewiesen werden: Ausgewählte Berechtigungen sind weniger als Standard-Berechtigungssatz
HandlerSearchAllResults: Alle Ergebnisse
HandlerSearchNoResultsMsgTryFollowing: Keine Ergebnisse gefunden. Versuchen Sie Folgendes:
HandlerSearchNoResultsMsgSpelledCorrectly: Stellen Sie sicher, dass alle Wörter richtig geschrieben sind.
HandlerSearchNoResultsMsgTryDifferent: Probieren Sie verschiedene Suchbegriffe.
HandlerSearchNoResultsMsgMoreGeneral: Probieren Sie allgemeinere Suchbegriffe.
HandlerSearchNoResultsMsgNoFindProdVer: Finden Sie Ihr Produkt oder Ihre Version nicht? Gehen Sie zum Intel Security ServicePortal.
HandlerSearchNoResults: Keine Ergebnisse
HandlerSearchOneResult: Ein Ergebnis
HandlerSitemapFile: Sitemap-Datei
HandlerSitemapFileUploaded: Sitemap wurde erfolgreich aktualisiert.
HandlerSubjectSchemeInvalidSubjectSchemeLocalizationFile: Lokalisierungsdatei für Betreffschema ist ungültig.
HandlerSubjectSchemeLangDeleted lang@Text: Lokalisierungsdatei für #{lang} wurde gelöscht.
HandlerSubjectSchemeLangsAvailable: Verfügbare Sprachen
HandlerSubjectSchemeLangsDeleteConfirm: Möchten Sie die Lokalisierungsdatei wirklich löschen? 
HandlerSubjectSchemeLangsDeleteError: Fehler beim Löschen der Lokalisierungsdatei.
HandlerSubjectSchemeLangsNewFile: Lokalisierungsdatei für neues Betreffschema hochladen
HandlerSubjectSchemeLangUpdated lang@Text: Lokalisierungsdatei für #{lang} wurde aktualisiert.
HandlerSubjectSchemeLangUploaded lang@Text: Lokalisierungsdatei für #{lang} wurde hochgeladen. 
HandlerSubjectSchemeProblemOccurredWhileUploadingSubjectScheme: Beim Hochladen des Betreffschemas ist ein Problem aufgetreten.
HandlerSubjectSchemeSubjectSchemeUploadedSuccessfully: Betreffschema wurde erfolgreich hochgeladen.
HandlerSubjectSchemeUnknownLanguageCode: Unbekannter Sprach-Code
HandlerSubjectSchemeUpdated: Betreffschema wurde aktualisiert
HandlerSubjectSchemeXMLFile: XML-Datei für Betreffschema
HandlerUploadBundleBundle: Paket
HandlerUploadBundleDeleteError x@Text: Fehler beim Löschen von #{x}
HandlerUploadBundleDeleteSuccess x@Text: #{x} wurde erfolgreich gelöscht.
HandlerUploadBundleError: Fehler
HandlerUploadBundleErrorPleaseUpdateSuiteBundleVersion: Fehler – Aktualisieren Sie Ihre Paketversion.
HandlerUploadBundleNoContentToDelete x@Text: Kein zu löschender Inhalt in #{x} 
HandlerUploadBundleOneBundleError: Beim Auffüllen des hochgeladenen Pakets ist ein Fehler aufgetreten.
HandlerUploadBundlePublicationUploadedSuccessfully: Publikation wurde erfolgreich hochgeladen.
HandlerUploadBundleSheaf: sheaf
HandlerUsersAddedSuccess: Benutzer wurde erfolgreich hinzugefügt
HandlerUsersBadEmail: Diese E-Mail-Adresse ist nicht registriert.
HandlerUsersCRCreated: Inhaltsrollengruppe wurde erstellt
HandlerUsersCRGroupNameInUse: Inhaltsrollenname wird bereits verwendet.
HandlerUsersCRSetGroupName: Legen Sie einen Namen für diese Inhaltsrollengruppe fest.
HandlerUsersCRUpdated: Inhaltsrollengruppe wurde aktualisiert
HandlerUsersDefineCR: Neue Inhaltsrollengruppe definieren
HandlerUsersDeleteSuccess: Benutzer wurde erfolgreich gelöscht.
HandlerUsersEmailError: Fehler beim Senden der E-Mail zum Zurücksetzen des Kennworts
HandlerUsersInvalidToken: Ungültiges Token
HandlerUsersNoResetToken: Kein Zurücksetzungs-Token
HandlerUsersNoRoleIdFound: Keine Rollen-ID gefunden
HandlerUsersPasswordEmailSent: E-Mail zum Zurücksetzen des Kennworts wurde gesendet
HandlerUsersRegisterSuccess: Benutzer wurde erfolgreich registriert.
HandlerUsersResetPasswordError: Fehler beim Zurücksetzen des Kennworts
HandlerUsersRolesUpdated: Benutzerrollen wurden aktualisiert
HandlerUsersUnableToAssignUserPermissionRole: Zuweisen der Benutzer-Berechtigungsrolle ist nicht möglich.
HandlerUsersUnknownError: Unbekannter Fehler
HideTOC: Inhaltsverzeichnis ausblenden
ImportAddHelperProblemRunningAddHelper: Problem bei der Ausführung von addHelper
ImportBundlesTooManyTopics num@Int: Sie können maximal #{show num} Themen veröffentlichen. Wählen Sie weniger Themen aus und versuchen Sie es erneut.
ImportElasticAnalyzerError: – Hinweis: Benutzerdefinierter Analyse-Fehler, Details finden Sie im Protokoll. Mit Standardanalyse 
ImportElasticErrorRebuilding: Bei der Indexneuerstellung ist ein Fehler aufgetreten, weitere Details finden Sie im Protokoll.
ImportElasticErrorUpdating: Bei der Indexaktualisierung ist ein Fehler aufgetreten, weitere Details finden Sie im Protokoll.
ImportElasticIndexRebuilt x@Text: Index erfolgreich neu erstellt #{x}
ImportElasticIndexUpdated x@Text: Index erfolgreich aktualisiert #{x}
ImportElasticNoPagesFound: In der Datenbank wurden keine Seiten gefunden – Index zurückgesetzt.
ImportElasticNoPagesInBundle: Beim Hochladen wurden keine Seiten gefunden.
ImportInvalidPassword: Ungültiges Kennwort
ImportRatingsOneRating: 1 Bewertung
ImportRatingsRatings: Bewertungen
ImportRolesPermissionDenied: Die Berechtigung wurde verweigert.
ImportSearchNoCategoriesUploaded: Es wurde keine Kategorie-XML-Datei hochgeladen.
ImportSearchUnknownTopicLink: *** unbekannter Link zum Thema ***
ImportUsersCaptchaError: Ungültiges reCAPTCHA 
ImportUsersCaptchaParseError: Es ist ein Fehler beim reCAPTCHA aufgetreten.
ImportUsersEmailFieldError: Es wurde kein Feld für E-Mail gefunden.
ImportUsersFldEmail: E-Mail
ImportUsersFldFirstName: Vorname
ImportUsersFldLastName: Nachname
ImportUsersFldPassword: Kennwort
ImportUsersFldReenterPass: Kennwort erneut eingeben
ImportUsersInvalidPass: Ungültiges Kennwort: Das ausgewählte Kennwort muss mindestens acht Zeichen enthalten, darunter mindestens ein Großbuchstabe, ein Kleinbuchstabe, ein Sonderzeichen und eine Zahl.
LoggedInAs email@Text: Angemeldet als #{email}.
Manuals: Handbücher
PDFPage: Seite
ProductDocumentationSplashTitle: Produktdokumentation 
PublishHowto: Veröffentlichen
ResultsPerPage: Ergebnisse pro Seite
ResultsPerPageShowFirst: pro Seite
ResultsPerPageShow: anzeigen
Search: Produktdokumentation durchsuchen
SearchContent: Diese Inhalte durchsuchen
SearchHome: Produktdokumentation durchsuchen
ShowTOC: Inhaltsverzeichnis einblenden
SSOLoginParamError: Bei den SSO-Anmeldeparametern ist ein Fehler aufgetreten.
SSOLoginTryAgain: Versuchen Sie, sich erneut einzuloggen mit
SwitchLang: Sprache ändern
TemplaesBundlesTitle: Dokumentationsbibliothek
TemplateAddHelperCancel: Abbrechen
TemplateAddHelperSave: Speichern
TemplateAddHelperSaveAndClose: Speichern und Schließen
TemplateAddUserAddUser: Benutzer hinzufügen
TemplateAddUserCancel: Abbrechen
TemplateAddUserPasswordMessage: Das Kennwort muss mindestens acht Zeichen enthalten, darunter mindestens ein Großbuchstabe, ein Kleinbuchstabe, ein Sonderzeichen und eine Zahl.
TemplateAdminArticleManagement: Artikelverwaltung
TemplateAdminContentRoleGroups: Inhaltsrollengruppen
TemplateAdminCSHConfigFile: CSH-Konfigurationsdatei herunterladen oder aktualisieren
TemplateAdminElasticReindex: Suchindex neu erstellen
TemplateAdminExportComments: Kommentare exportieren
TemplateAdminExportRatings: Bewertungen exportieren
TemplateAdminManageManuals: Handbücher verwalten
TemplateAdminManageResourceManuals: Ressourcenpakete verwalten
TemplateAdminResourceIdCsv: Ressourcen-IDs in Excel-Datei herunterladen
TemplateAdminSitemap: Sitemap verwalten
TemplateAdminSubjectSchemeLocalization: Betreffschemalokalisierung verwalten
TemplateAdminTitle: Verwaltung
TemplateAdminUploadCategoryXML: Kategorie-XML-Datei verwalten
TemplateAdminUploadCategoryXml: XML-Datei für neue Kategorie hochladen
TemplateAdminUploadNewLangFile: Neue Codedatei für die Standardsprache hochladen
TemplateAdminUploadSubjectScheme: Betreffschema verwalten
TemplateAdminUserGroups: Benutzergruppen
TemplateAdminUserManagement: Benutzerverwaltung
TemplateAdminUserRoles: Benutzerrollen
TemplateBundlePageCollapse: Reduzieren
TemplateBundlePageCollapseTooltip: Alle Titel reduzieren
TemplateBundlePageComments: Kommentare
TemplateBundlePageContents: Inhalt
TemplateBundlePageExpand: Erweitern
TemplateBundlePageExpandTooltip: Inhaltsverzeichnis einblenden
TemplateBundlePageFeedback: Feedback
TemplateBundlePageFeedbackThankYou: Vielen Dank! Ihre Kommentare wurden abgesendet. 
TemplateBundlePageFeedbackTooltip: Feedback übermitteln
TemplateBundlePageFilterTitle: Wählen Sie mindestens eine Option aus.
TemplateBundlePageNext: Weiter
TemplateBundlePageNextTopicTooltip: Zum nächsten Thema
TemplateBundlePageNo: Nein
TemplateBundlePagePrevious: Zurück 
TemplateBundlePagePrevTopicTooltip: Zum vorherigen Thema
TemplateBundlePagePrint: Drucken
TemplateBundlePagePrintTooltip: Thema drucken
TemplateBundlePagePrivacy: Fügen Sie aus Datenschutzgründen Ihrem Feedback keine Kontaktinformationen hinzu. Lesen Sie unsere
TemplateBundlePagePrivacyLast: Datenschutzrichtlinien.
TemplateBundlePageProvideFeedbackCharsLeft: Zeichen übrig
TemplateBundlePageProvideFeedbackTooltip: Feedback geben
TemplateBundlePageSaveAsPDF: Als PDF speichern
TemplateBundlePageSavePDFTooltip: Als PDF speichern
TemplateBundlePageSaveSelectedTopic: Ausgewähltes Thema speichern
TemplateBundlePageSaveSelectedTopicAndSubtopics: Ausgewähltes Thema und untergeordnete Themen speichern
TemplateBundlePageSeeAlso: Siehe auch
TemplateBundlePageSend: Senden
TemplateBundlePageSendLink: Senden
TemplateBundlePageSendLinkTooltip: Link zum Thema senden
TemplateBundlePageSubmit: Senden
TemplateBundlePageWasThisInformationHelpful: Waren diese Informationen hilfreich?
TemplateBundlePageYEs: Ja
TemplateBundlesDeleteLanguage: Sprache löschen
TemplateBundlesDeleteManual: Handbuch löschen
TemplateBundlesDownload: Paket herunterladen
TemplateBundlesDownloadClassification: Klassifizierungs-XML herunterladen
TemplateBundlesHiddenBundle: Ausgeblendetes Handbuch
TemplateBundlesSearchManuals: Handbücher durchsuchen
TemplateBundlesUploadClassification: Klassifizierungs-XML hochladen
TemplateClassificationForManual: Für Handbuch
TemplateClassificationUploadClassificationMap: Klassifizierungszuordnungs-XML hochladen
TemplateClassificationWarnReindex: HINWEIS: Das Hochladen einer Klassifizierungszuordnung führt dazu, dass die gesamte Site neu indiziert wird. Dieser Vorgang kann einige Minuten dauern.
TemplateContentRolesCRGroups: Inhaltsrollengruppen
TemplateContentRolesDefineNewCR: Neue Inhaltsrolle definieren
TemplateDefaultLayoutAdministration: Verwaltung
TemplateDefaultLayoutArticles: Artikel
TemplateDefaultLayoutBrowseDocumentation: Durchsuchen
TemplateDefaultLayoutDocumentation: Dokumentationsbibliothek
TemplateDefaultLayoutHome: Startseite
TemplateDefaultLayoutLanguages: United States – English
TemplateDefaultLayoutLinksCareers: Jobs
TemplateDefaultLayoutLinksContactUs: Kontakt
TemplateDefaultLayoutLinksIntelCorp: © Intel Corporation
TemplateDefaultLayoutLinksLegalContractsandTerms: Verträge und Bedingungen
TemplateDefaultLayoutLinksLegalNotices: Rechtliche Hinweise  
TemplateDefaultLayoutLinksPrivacy: Privatsphäre
TemplateDefaultLayoutLinksSiteMap: Siteübersicht
TemplateDefaultLayoutLinksWebsiteFeedback: Feedback zur Website
TemplateDefaultLayoutLogout: Abmelden
TemplateDefaultLayoutProfile: Profil
TemplateDefaultLayoutVideos: Videos
TemplateFilterCurrentPublication: Aktuelle Publikation
TemplateRequestResetPasswordEmail: E-Mail
TemplateRequestResetPasswordSubmit: E-Mail zum Zurücksetzen des Kennworts anfragen
TemplateSearchCurrentPublication name@Text: Die aktuelle Suche ist auf die Publikation '#{name}' beschränkt.
TemplateSearchPageClearTooltip: Filter löschen
TemplateSearchPageFirstPageTooltip: Zur ersten Seite
TemplateSearchPageLastPageTooltip: Zur letzten Seite
TemplateSearchPageNextPageTooltip: Zur nächsten Seite
TemplateSearchPagePrevPageTooltip: Zur vorherigen Seite wechseln
TemplateSearchPublicationTitle: Publikation
TemplateSearchSortbyCreatedAsc: Erstellt am – Aufsteigend
TemplateSearchSortbyCreatedDec: Erstellt am – absteigend
TemplateSearchSortbyScore: Faktor
TemplateSearchSortbyUpdatedAsc: Hinzugefügt am – Aufsteigend
TemplateSearchSortbyUpdatedDec: Hinzugefügt am – Absteigend
TemplateSearchSortbyViews: Anzahl der Ansichten
TemplatesSearchPageClear: Löschen
TemplatesSearchPageCurrentResultsFirst: Ergebnisse
TemplatesSearchPageCurrentResults: von
TemplatesSearchPageRefilneResults: Ergebnisse einschränken
TemplatesSearchPageResultUpdated: Aktualisiert
TemplateUploadSitemapDisable: Sitemap deaktivieren
TemplateUploadSitemapDisabled: Sitemap wurde deaktiviert.
TemplateUploadSitemapDisabledWord: Deaktiviert
TemplateUploadSitemapDownloadSitemap: sitemap.xml herunterladen
TemplateUploadSitemapEnable: Sitemap aktivieren
TemplateUploadSitemapEnabled: Sitemap aktiviert
TemplateUploadSitemapEnabledWord: Aktiviert
TemplateUploadSitemapLegend: sitemap.xml hochladen
TemplateUploadSitemapStatus sts@Text: Sitemap ist #{sts}
TextPass txt@Text: #{txt}
Upload: Hochladen
UploadLink: Publikation hochladen
YesodAuthStormPathSSOErrorOccured: Es ist ein Fehler aufgetreten.
YesodAuthStormPathSSOLoginParamError: Bei den SSO-Anmeldeparametern ist ein Fehler aufgetreten.
YesodAuthStormPathSSOLoginTryAgain: Versuchen Sie, sich erneut einzuloggen mit
