AdvancedSearch: 고급 검색 
AdvancedSearchTooltip: 콘텐츠 필터 선택
BreadcrumbsProductDocumentationHome: 제품 설명서 홈
BreadcrumbsSearch: 검색
Cancel: 취소
Close: 닫기
DeleteText: 삭제
ErrorOccured: 오류 발생
FilterUsers: 사용자 필터링:
FoundationLoginOnly: 로그온
FoundationLoginRegister: 로그온 / 등록
HandlerAdminOnlyAdmin: 액세스가 거부됨
HandlerBundlePageAltCSHResult: 대체 CSH 항목이 발견됨
HandlerCategoriesCategoryXMLFileUploaded: 범주 XML 파일이 업로드됨
HandlerClassificationUpdated: 분류 맵이 업데이트됨
HandlerClassificationXMLFile: 업데이트된 분류 맵
HandlerCommentsComments: 개 의견
HandlerCommentsOneComment: 1개 의견
HandlerCommentsPostedCommentOn: 의견이 게시된 위치:
HandlerContentRolesAreYouSureDelete: 이 콘텐츠 역할을 삭제하시겠습니까?
HandlerContentRolesCRDeleted: 콘텐츠 역할이 삭제됨
HandlerContentRolesErrorDeleting: 문제가 발생했습니다. 콘텐츠 역할이 삭제되지 않았습니다.
HandlerCshAlternateCSHTopicFound: 대체 CSH 항목이 발견됨
HandlerCshCSHRulesUpdated: CSH 규칙이 업데이트됨
HandlerCshInvalidAliases: CSH URL에서 잘못된 별칭 키가 발견됨
HandlerCshInvalidCSHRulesFile: 잘못된 CSH 규칙 파일
HandlerCshNewCshFile: 새 CSH 구성 파일 업로드
HandlerCshReservedAliasesUsed: CSH 구성 파일에서 예약된 별칭이 사용됨
HandlerCustomError400H2: 400
HandlerCustomError400H3: 잘못된 요청
HandlerCustomError401H2: 401
HandlerCustomError401H3: 권한 없음
HandlerCustomError403H2: 403
HandlerCustomError403H3: 사용할 수 없음
HandlerCustomError404H2: 404
HandlerCustomError404H3: 찾을 수 없음
HandlerCustomError405H2: 405
HandlerCustomError405H3: 방식 허용 안 함
HandlerCustomError500H2: 500
HandlerCustomError500H3: 내부 서버 오류
HandlerFontoDocumentSaved: 문서가 저장됨
HandlerFontoErrorGeneratingUUID: UUID 생성 중 오류 발생
HandlerFontoErrorParsingID: ID 구문 분석 중 오류 발생
HandlerFontoErrorParsingXML: XML 구문 분석 중 오류 발생
HandlerFontoErrorParsingXMLToDocument: XML에서 문서로 구문 분석 중 오류 발생
HandlerFontoNoFileFound: 파일이 없음
HandlerFontoNoIDFound: ID가 없음
HandlerFontoUntitledFromCursor: 제목 없음 – 커서에서
HandlerGroupsErrorReadingGroupID: 그룹 ID를 읽는 중 오류 발생
HandlerGroupsGroupUpdated: 그룹이 업데이트됨
HandlerGroupsMustUseUniqueGroupName: 고유 그룹 이름을 사용해야 함
HandlerGroupsNoGroupNameFound: 그룹 이름이 없음
HandlerGroupsUnableAssignRole: 역할을 할당할 수 없음
HandlerHowtoContent: 콘텐츠
HandlerHowtoDeleted: 문서가 삭제됨
HandlerHowtoInsufficientPermissions: 이 문서를 편집할 권한이 없음
HandlerHowtoSaved: 저장됨
HandlerHowtoTitle: 제목
HandlerHtmlEmptyMyDocs: 빈 MyDocs
HandlerLangDefaultLanguageCodeFileUpdated: 업데이트된 기본 언어 코드 파일
HandlerLangNewLangFile: 새 기본 언어 코드 파일 업로드
HandlerMyPubSourcePublication: 소스 게시
HandlerProfileDisplayName: 표시 이름
HandlerProfileScreenName: 화면 이름
HandlerProfileUpdated: 프로파일이 업데이트됨
HandlerProfileUsernameInUse: 사용자 이름이 있음
HandlerRatingsInvalidRating: 잘못된 등급
HandlerRatingsRatingRecorded: 등급이 기록되었습니다.
HandlerRatingsRatingUpdated: 등급이 업데이트되었습니다.
HandlerRolesErrorReadingRoleID: 역할 ID를 읽는 중 오류 발생
HandlerRolesMustUseUniqueRoleName: 고유 역할 이름을 사용하십시오.
HandlerRolesNoRoleNameFound: 역할 이름이 없음
HandlerRolesNotEnoughAdminUsersRemaining: 사용자를 할당할 수 없음
HandlerRolesSelectedPermissionsLessThenDefault: 권한을 할당할 수 없음: 선택한 권한이 기본 권한 집합보다 적습니다.
HandlerSearchAllResults: 모든 결과
HandlerSearchNoResults: 결과 없음
HandlerSearchOneResult: 1개 결과
HandlerSitemapFile: 사이트 맵 파일
HandlerSitemapFileUploaded: 사이트 맵을 성공적으로 업데이트함
HandlerSubjectSchemeInvalidSubjectSchemeLocalizationFile: 잘못된 주제 체계 지역화 파일
HandlerSubjectSchemeLangDeleted lang@Text: #{lang} 삭제된 지역화 파일
HandlerSubjectSchemeLangsAvailable: 사용 가능한 언어
HandlerSubjectSchemeLangsDeleteConfirm: 지역화 파일을 삭제하시겠습니까? 
HandlerSubjectSchemeLangsDeleteError: 지역화 파일을 삭제하는 중 오류가 발생했습니다.
HandlerSubjectSchemeLangsNewFile: 새 SubjectScheme 지역화 파일 업로드
HandlerSubjectSchemeLangUpdated lang@Text: #{lang} 업데이트된 지역화 파일
HandlerSubjectSchemeLangUploaded lang@Text: #{lang} 업로드된 지역화 파일 
HandlerSubjectSchemeProblemOccurredWhileUploadingSubjectScheme: 주제 체계를 업로드하는 중 문제가 발생했습니다.
HandlerSubjectSchemeSubjectSchemeUploadedSuccessfully: 주제 체계가 성공적으로 업로드됨
HandlerSubjectSchemeUnknownLanguageCode: 알 수 없는 언어 코드
HandlerSubjectSchemeUpdated: 주제 체계가 업데이트됨
HandlerSubjectSchemeXMLFile: 주제 체계 XML 파일
HandlerUploadBundleBundle: 번들
HandlerUploadBundleDeleteError x@Text: #{x}을(를) 삭제하는 중 오류 발생
HandlerUploadBundleDeleteSuccess x@Text: #{x}을(를) 성공적으로 삭제함
HandlerUploadBundleError: 오류
HandlerUploadBundleErrorPleaseUpdateSuiteBundleVersion: 오류 – 번들 버전을 업데이트하십시오.
HandlerUploadBundleNoContentToDelete x@Text: #{x}에 삭제할 콘텐츠가 없음 
HandlerUploadBundleOneBundleError: 업로드된 번들을 채우는 중 오류 발생
HandlerUploadBundlePublicationUploadedSuccessfully: 게시를 성공적으로 업로드함
HandlerUploadBundleSheaf: sheaf
HandlerUsersAddedSuccess: 사용자가 성공적으로 추가됨
HandlerUsersBadEmail: 해당 이메일 주소가 등록되어 있지 않습니다.
HandlerUsersCRCreated: 콘텐츠 역할 그룹이 만들어짐
HandlerUsersCRGroupNameInUse: 콘텐츠 역할 이름이 이미 사용 중입니다.
HandlerUsersCRSetGroupName: 이 콘텐츠 역할 그룹의 이름을 설정하십시오.
HandlerUsersCRUpdated: 콘텐츠 역할 그룹이 업데이트됨
HandlerUsersDefineCR: 새 콘텐츠 역할 그룹 정의
HandlerUsersDeleteSuccess: 사용자를 성공적으로 삭제함
HandlerUsersEmailError: 암호 재설정 이메일을 보내는 중 오류 발생
HandlerUsersInvalidToken: 잘못된 토큰
HandlerUsersNoResetToken: 재설정 토큰이 없음
HandlerUsersNoRoleIdFound: 역할 ID가 없음
HandlerUsersPasswordEmailSent: 암호 재설정 이메일을 보냄
HandlerUsersRegisterSuccess: 사용자를 성공적으로 등록함
HandlerUsersResetPasswordError: 암호 재설정 중 오류 발생
HandlerUsersRolesUpdated: 사용자 역할이 업데이트됨
HandlerUsersUnableToAssignUserPermissionRole: 사용자 권한 역할을 할당할 수 없음
HandlerUsersUnknownError: 알 수 없는 오류
HideTOC: 목차 숨기기
ImportAddHelperProblemRunningAddHelper: addHelper 실행 중 문제 발생
ImportBundlesTooManyTopics num@Int: 최대 #{show num}개 항목을 게시할 수 있습니다. 더 적은 수의 항목을 선택하고 다시 시도하십시오.
ImportElasticAnalyzerError: - 참고: 사용자 지정 분석기 오류입니다. 자세한 내용은 로그를 참조하십시오. 기본 분석기를 사용 중입니다. 
ImportElasticErrorRebuilding: 인덱스를 다시 빌드하는 중 오류가 발생했습니다. 자세한 내용은 로그를 참조하십시오.
ImportElasticErrorUpdating: 인덱스를 업데이트하는 중 오류가 발생했습니다. 자세한 내용은 로그를 참조하십시오.
ImportElasticIndexRebuilt x@Text: 인덱스가 성공적으로 다시 빌드됨 #{x}
ImportElasticIndexUpdated x@Text: 인덱스가 성공적으로 업데이트됨 #{x}
ImportElasticNoPagesFound: 데이터베이스에 페이지가 없음 - 인덱스를 재설정합니다.
ImportElasticNoPagesInBundle: 업로드할 페이지가 없음
ImportInvalidPassword: 잘못된 암호
ImportRatingsOneRating: 1등급
ImportRatingsRatings: 등급
ImportRolesPermissionDenied: 권한이 거부됨
ImportSearchNoCategoriesUploaded: 업로드한 범주 XML 파일 없음
ImportSearchUnknownTopicLink: *** 알 수 없는 항목 링크 ***
ImportUsersCaptchaError: 잘못된 reCAPTCHA 
ImportUsersCaptchaParseError: reCAPTCHA 오류
ImportUsersEmailFieldError: 이메일 필드가 없습니다.
ImportUsersFldEmail: 이메일
ImportUsersFldFirstName: 이름
ImportUsersFldLastName: 성
ImportUsersFldPassword: 암호
ImportUsersFldReenterPass: 암호 재입력
ImportUsersInvalidPass: 잘못된 암호: 선택한 암호는 8자 이상이어야 하며 최소 대문자 1개, 소문자 1개, 특수 문자 1개 및 숫자 1개를 포함해야 합니다.
LoggedInAs email@Text: #{email}(으)로 로그인되었습니다.
Manuals: 설명서
PDFPage: 페이지
ProductDocumentationSplashTitle: 제품 설명서 
PublishHowto: 게시
ResultsPerPage: 페이지당 결과
ResultsPerPageShow: 페이지당 xx개 표시
Search: 제품 설명서 검색
SearchContent: 이 콘텐츠 검색
SearchHome: 제품 설명서 검색
ShowTOC: 목차 표시
SSOLoginParamError: SSO 로그인 매개 변수에 오류가 있습니다.
SSOLoginTryAgain: 다음을 사용하여 다시 로그인하십시오.
SwitchLang: 언어 변경
TemplaesBundlesTitle: 설명서 라이브러리
TemplateAddHelperCancel: 취소
TemplateAddHelperSave: 저장
TemplateAddHelperSaveAndClose: 저장 및 닫기
TemplateAddUserAddUser: 사용자 추가
TemplateAddUserCancel: 취소
TemplateAddUserPasswordMessage: 암호는 8자 이상이어야 하며 최소 대문자 1개, 소문자 1개, 특수 문자 1개 및 숫자 1개를 포함해야 합니다.
TemplateAdminArticleManagement: 문서 관리
TemplateAdminContentRoleGroups: 콘텐츠 역할 그룹
TemplateAdminCSHConfigFile: CSH 구성 파일 다운로드 또는 업데이트
TemplateAdminElasticReindex: 검색 인덱스 다시 만들기
TemplateAdminExportComments: 설명 내보내기
TemplateAdminExportRatings: 등급 내보내기
TemplateAdminManageManuals: 설명서 관리
TemplateAdminManageResourceManuals: 리소스 패키지 관리
TemplateAdminResourceIdCsv: ResourceIds Excel 파일 다운로드
TemplateAdminSitemap: 사이트 맵 관리
TemplateAdminSubjectSchemeLocalization: 주제 체계 지역화 관리
TemplateAdminTitle: 관리
TemplateAdminUploadCategoryXML: 범주 XML 파일 관리
TemplateAdminUploadCategoryXml: 새 범주 XML 파일 업로드
TemplateAdminUploadNewLangFile: 새 기본 언어 코드 파일 업로드
TemplateAdminUploadSubjectScheme: 주제 체계 관리
TemplateAdminUserGroups: 사용자 그룹
TemplateAdminUserManagement: 사용자 관리
TemplateAdminUserRoles: 사용자 역할
TemplateBundlePageCollapse: 축소
TemplateBundlePageCollapseTooltip: 모든 제목 축소
TemplateBundlePageComments: 설명
TemplateBundlePageContents: 목차
TemplateBundlePageExpand: 확장
TemplateBundlePageExpandTooltip: 목차 확장
TemplateBundlePageFeedback: 피드백
TemplateBundlePageFeedbackThankYou: 감사합니다. 의견이 전달되었습니다. 
TemplateBundlePageFeedbackTooltip: 피드백 제출
TemplateBundlePageFilterTitle: 하나 이상의 옵션 선택
TemplateBundlePageNext: 다음
TemplateBundlePageNextTopicTooltip: 다음 항목으로 이동
TemplateBundlePageNo: 아니요
TemplateBundlePagePrevious: 이전 
TemplateBundlePagePrevTopicTooltip: 이전 항목으로 이동
TemplateBundlePagePrint: 인쇄
TemplateBundlePagePrintTooltip: 항목 인쇄
TemplateBundlePagePrivacy: 개인 정보를 보호하려면 피드백에 연락처 정보를 포함하지 마십시오. 개인 정보 보호 정책을 검토하십시오.
TemplateBundlePageProvideFeedbackTooltip: 피드백 제공
TemplateBundlePageSaveAsPDF: PDF로 저장
TemplateBundlePageSavePDFTooltip: PDF로 저장
TemplateBundlePageSaveSelectedTopic: 선택 항목 저장
TemplateBundlePageSaveSelectedTopicAndSubtopics: 선택 항목 및 하위 항목 저장
TemplateBundlePageSeeAlso: 참조
TemplateBundlePageSend: 보내기
TemplateBundlePageSendLink: 보내기
TemplateBundlePageSendLinkTooltip: 항목에 대한 링크 보내기
TemplateBundlePageSubmit: 제출
TemplateBundlePageWasThisInformationHelpful: 이 정보가 유용합니까?
TemplateBundlePageYEs: 예
TemplateBundlesDeleteLanguage: 언어 삭제
TemplateBundlesDeleteManual: 설명서 삭제
TemplateBundlesDownload: 번들 다운로드
TemplateBundlesDownloadClassification: 분류 XML 다운로드
TemplateBundlesHiddenBundle: 숨겨진 설명서
TemplateBundlesSearchManuals: 설명서 검색
TemplateBundlesUploadClassification: 분류 XML 업로드
TemplateClassificationForManual: 설명서:
TemplateClassificationUploadClassificationMap: 분류 맵 XML 업로드
TemplateClassificationWarnReindex: 참고: 분류 맵을 업로드하면 전체 사이트가 다시 인덱싱됩니다. 이 작업을 완료하는 데 몇 분 정도 걸릴 수 있습니다.
TemplateContentRolesCRGroups: 콘텐츠 역할 그룹
TemplateContentRolesDefineNewCR: 새 콘텐츠 역할 정의
TemplateDefaultLayoutAdministration: 관리
TemplateDefaultLayoutArticles: 문서
TemplateDefaultLayoutBrowseDocumentation: 찾아보기
TemplateDefaultLayoutDocumentation: 설명서 라이브러리
TemplateDefaultLayoutHome: 홈
TemplateDefaultLayoutLanguages: United States - English
TemplateDefaultLayoutLinksCareers: 채용 정보
TemplateDefaultLayoutLinksContactUs: 문의처
TemplateDefaultLayoutLinksIntelCorp: © Intel Corporation
TemplateDefaultLayoutLinksLegalContractsandTerms: 법적 계약 및 기간
TemplateDefaultLayoutLinksLegalNotices: 법적 고지 사항 
TemplateDefaultLayoutLinksPrivacy: 은둔
TemplateDefaultLayoutLinksSiteMap: 사이트 맵
TemplateDefaultLayoutLinksWebsiteFeedback: 웹 사이트 피드백
TemplateDefaultLayoutLogout: 로그아웃
TemplateDefaultLayoutProfile: 프로파일
TemplateDefaultLayoutVideos: 비디오
TemplateFilterCurrentPublication: 현재 게시
TemplateRequestResetPasswordEmail: 이메일
TemplateRequestResetPasswordSubmit: 암호 재설정 요청 이메일
TemplateSearchCurrentPublication name@Text: 현재 검색이 '#{name}' 게시로 제한됩니다.
TemplateSearchPageClearTooltip: 필터 지우기
TemplateSearchPageFirstPageTooltip: 첫 번째 페이지로 이동
TemplateSearchPageLastPageTooltip: 마지막 페이지로 이동
TemplateSearchPageNextPageTooltip: 다음 페이지로 이동
TemplateSearchPagePrevPageTooltip: 이전 페이지로 이동
TemplateSearchPublicationTitle: 게시
TemplateSearchSortbyCreatedAsc: 만든 날짜 - 오름차순
TemplateSearchSortbyCreatedDec: 만든 날짜 - 내림차순
TemplateSearchSortbyScore: 점수
TemplateSearchSortbyUpdatedAsc: 추가된 날짜 - 오름차순
TemplateSearchSortbyUpdatedDec: 추가된 날짜 - 내림차순
TemplateSearchSortbyViews: 조회 수
TemplatesSearchPageClear: 지우기
TemplatesSearchPageCurrentResults: 결과 xx-yy/zzz
TemplatesSearchPageRefilneResults: 결과 구체화
TemplatesSearchPageResultUpdated: 업데이트됨
TemplateUploadSitemapDisable: 사이트 맵 사용 안 함
TemplateUploadSitemapDisabled: 사이트 맵을 사용하지 않도록 설정함
TemplateUploadSitemapDisabledWord: 사용 안 함
TemplateUploadSitemapDownloadSitemap: sitemap.xml 다운로드
TemplateUploadSitemapEnable: 사이트 맵 사용
TemplateUploadSitemapEnabled: 사이트 맵을 사용하도록 설정함
TemplateUploadSitemapEnabledWord: 사용
TemplateUploadSitemapLegend: sitemap.xml 업로드
TemplateUploadSitemapStatus sts@Text: 사이트 맵이 #{sts}입니다.
TemplTemplateBundlePageProvideFeedbackTooltip: 피드백 제출
TextPass txt@Text: #{txt}
Upload: 업로드
UploadLink: 게시물 업로드
YesodAuthStormPathSSOErrorOccured: 오류 발생
YesodAuthStormPathSSOLoginParamError: SSO 로그인 매개 변수에 오류가 있습니다.
YesodAuthStormPathSSOLoginTryAgain: 다음을 사용하여 다시 로그인하십시오.