AdvancedSearch: Wyszukiwanie zaawansowane 
AdvancedSearchTooltip: Wybierz filtry zawartości
BreadcrumbsProductDocumentationHome: Strona główna dokumentacji produktu
BreadcrumbsSearch: Wyszukaj
Cancel: Anuluj
Close: Zamknij
DeleteText: Usuń
ErrorOccured: Wystąpił błąd
FilterUsers: Filtruj użytkowników:
FoundationLoginOnly: Zaloguj się
FoundationLoginRegister: Zaloguj się / Zarejestruj się
HandlerAdminOnlyAdmin: Odmowa dostępu
HandlerBundlePageAltCSHResult: Znaleziono alternatywny temat CSH
HandlerCategoriesCategoryXMLFileUploaded: Przesłano plik XML kategorii
HandlerClassificationUpdated: Mapa klasyfikacji została zaktualizowana
HandlerClassificationXMLFile: Zaktualizowana mapa klasyfikacji
HandlerCommentsComments: komentarze
HandlerCommentsOneComment: 1 komentarz
HandlerCommentsPostedCommentOn: zamieszczono komentarz w:
HandlerContentRolesAreYouSureDelete: Czy na pewno chcesz usunąć tę rolę zawartości?
HandlerContentRolesCRDeleted: Rola zawartości została usunięta
HandlerContentRolesErrorDeleting: Wystąpił problem. Rola zawartości nie została usunięta.
HandlerCshAlternateCSHTopicFound: Znaleziono alternatywny temat CSH
HandlerCshCSHRulesUpdated: Zaktualizowano reguły CSH
HandlerCshInvalidAliases: W adresie URL CSH znaleziono nieprawidłowe klucze aliasów
HandlerCshInvalidCSHRulesFile: Nieprawidłowy plik reguł CSH
HandlerCshNewCshFile: Prześlij nowy plik konfiguracji CSH
HandlerCshReservedAliasesUsed: W pliku konfiguracji CSH użyto zarezerwowanych aliasów
HandlerCustomError400H2: 400
HandlerCustomError400H3: Nieprawidłowe żądanie
HandlerCustomError401H2: 401
HandlerCustomError401H3: Nieautoryzowane
HandlerCustomError403H2: 403
HandlerCustomError403H3: Zabronione
HandlerCustomError404H2: 404
HandlerCustomError404H3: Nie znaleziono
HandlerCustomError405H2: 405
HandlerCustomError405H3: Niedozwolona metoda
HandlerCustomError500H2: 500
HandlerCustomError500H3: Wewnętrzny błąd serwera
HandlerFontoDocumentSaved: Dokument został zapisany
HandlerFontoErrorGeneratingUUID: Błąd podczas generowania UUID
HandlerFontoErrorParsingID: Błąd podczas analizy identyfikatora
HandlerFontoErrorParsingXML: Błąd podczas analizy XML
HandlerFontoErrorParsingXMLToDocument: Błąd podczas analizy XML w celu utworzenia dokumentu
HandlerFontoNoFileFound: Nie znaleziono pliku
HandlerFontoNoIDFound: Nie znaleziono identyfikatora
HandlerFontoUntitledFromCursor: Bez tytułu — z kursora
HandlerGroupsErrorReadingGroupID: Błąd podczas odczytu identyfikatora grupy
HandlerGroupsGroupUpdated: Grupa została zaktualizowana
HandlerGroupsMustUseUniqueGroupName: Należy użyć unikatowej nazwy grupy
HandlerGroupsNoGroupNameFound: Nie znaleziono nazwy grupy
HandlerGroupsUnableAssignRole: Nie można przypisać roli
HandlerHowtoContent: Zawartość
HandlerHowtoDeleted: Artykuł został usunięty
HandlerHowtoInsufficientPermissions: Brak wystarczających uprawnień do edycji tego artykułu
HandlerHowtoSaved: Zapisano
HandlerHowtoTitle: Tytuł
HandlerHtmlEmptyMyDocs: Pusta strona Moje dokumenty
HandlerLangDefaultLanguageCodeFileUpdated: Zaktualizowano plik kodu języka domyślnego
HandlerLangNewLangFile: Prześlij nowy plik kodu języka domyślnego
HandlerMyPubSourcePublication: Publikacja źródłowa
HandlerProfileDisplayName: Nazwa wyświetlana
HandlerProfileScreenName: Pseudonim
HandlerProfileUpdated: Profil został zaktualizowany
HandlerProfileUsernameInUse: Nazwa użytkownika już istnieje
HandlerRatingsInvalidRating: Nieprawidłowa ocena
HandlerRatingsRatingRecorded: Twoja ocena została zapisana
HandlerRatingsRatingUpdated: Twoja ocena została zaktualizowana
HandlerRolesErrorReadingRoleID: Błąd podczas odczytu identyfikatora roli
HandlerRolesMustUseUniqueRoleName: Użyj unikatowej nazwy roli
HandlerRolesNoRoleNameFound: Nie znaleziono nazwy roli
HandlerRolesNotEnoughAdminUsersRemaining: Nie można przypisać użytkowników
HandlerRolesSelectedPermissionsLessThenDefault: Nie można przypisać uprawnień: Wybrany zestaw uprawnień jest mniejszy niż domyślny
HandlerSearchAllResults: Wszystkie wyniki
HandlerSearchNoResults: Brak wyników
HandlerSearchOneResult: Jeden wynik
HandlerSitemapFile: Plik mapy witryny
HandlerSitemapFileUploaded: Zaktualizowano pomyślnie mapę witryny.
HandlerSubjectSchemeInvalidSubjectSchemeLocalizationFile: Nieprawidłowy plik lokalizacji schematu tematu
HandlerSubjectSchemeLangDeleted lang@Text: Plik lokalizacji #{lang} został usunięty
HandlerSubjectSchemeLangsAvailable: Dostępne języki
HandlerSubjectSchemeLangsDeleteConfirm: Czy na pewno chcesz usunąć plik lokalizacji? 
HandlerSubjectSchemeLangsDeleteError: Wystąpił błąd podczas usuwania pliku lokalizacji.
HandlerSubjectSchemeLangsNewFile: Prześlij nowy plik lokalizacji schematu tematu
HandlerSubjectSchemeLangUpdated lang@Text: Plik lokalizacji #{lang} został zaktualizowany
HandlerSubjectSchemeLangUploaded lang@Text: Plik lokalizacji #{lang} został przesłany 
HandlerSubjectSchemeProblemOccurredWhileUploadingSubjectScheme: Wystąpił problem podczas przesyłania schematu tematu.
HandlerSubjectSchemeSubjectSchemeUploadedSuccessfully: Pomyślnie przesłano schemat tematu
HandlerSubjectSchemeUnknownLanguageCode: Nieznany kod języka
HandlerSubjectSchemeUpdated: Schemat tematu został zaktualizowany
HandlerSubjectSchemeXMLFile: Plik XML schematu tematu
HandlerUploadBundleBundle: zestaw
HandlerUploadBundleDeleteError x@Text: Błąd usuwania #{x}
HandlerUploadBundleDeleteSuccess x@Text: Pomyślnie usunięto #{x}
HandlerUploadBundleError: Błąd
HandlerUploadBundleErrorPleaseUpdateSuiteBundleVersion: Błąd — Zaktualizuj wersję zestawu
HandlerUploadBundleNoContentToDelete x@Text: Brak zawartość do usunięcia w #{x} 
HandlerUploadBundleOneBundleError: Błąd podczas wypełniania przesłanego zestawu
HandlerUploadBundlePublicationUploadedSuccessfully: Pomyślnie przesłano publikację
HandlerUploadBundleSheaf: sheaf
HandlerUsersAddedSuccess: Pomyślnie dodano użytkownika
HandlerUsersBadEmail: Ten adres e-mail nie został zarejestrowany
HandlerUsersCRCreated: Grupa roli zawartości została utworzona
HandlerUsersCRGroupNameInUse: Nazwa roli zawartości jest już używana
HandlerUsersCRSetGroupName: Ustaw nazwę dla tej grupy roli zawartości
HandlerUsersCRUpdated: Grupa roli zawartości została zaktualizowana
HandlerUsersDefineCR: Zdefiniuj nową grupę roli zawartości
HandlerUsersDeleteSuccess: Pomyślnie usunięto użytkownika
HandlerUsersEmailError: Wystąpił błąd podczas wysyłania wiadomości e-mail dotyczącej resetowania hasła
HandlerUsersInvalidToken: Nieprawidłowy token
HandlerUsersNoResetToken: Brak tokenu resetowania
HandlerUsersNoRoleIdFound: Nie znaleziono identyfikatora roli
HandlerUsersPasswordEmailSent: Wiadomość e-mail dotycząca resetowania hasła została wysłana
HandlerUsersRegisterSuccess: Pomyślnie zarejestrowano użytkownika
HandlerUsersResetPasswordError: Wystąpił błąd podczas resetowania hasła
HandlerUsersRolesUpdated: Role użytkownika zostały zaktualizowane
HandlerUsersUnableToAssignUserPermissionRole: Nie można przypisać roli uprawnienia użytkownika
HandlerUsersUnknownError: Nieznany błąd
HideTOC: Ukryj spis treści
ImportAddHelperProblemRunningAddHelper: Problem z uruchomieniem addHelper
ImportBundlesTooManyTopics num@Int: Maksymalna liczba tematów, które można opublikować: #{show num}. Wybierz mniej tematów i spróbuj ponownie.
ImportElasticAnalyzerError: - Uwaga: Błąd niestandardowego analizatora, szczegółowe informacje zawiera dziennik. Zostanie użyty domyślny analizator. 
ImportElasticErrorRebuilding: Błąd przebudowywania indeksu — szczegółowe informacje zawiera dziennik.
ImportElasticErrorUpdating: Błąd aktualizacji indeksu — szczegółowe informacje zawiera dziennik.
ImportElasticIndexRebuilt x@Text: Pomyślnie przebudowano indeks #{x}
ImportElasticIndexUpdated x@Text: Pomyślnie zaktualizowano indeks #{x}
ImportElasticNoPagesFound: Nie znaleziono stron w bazie danych — indeks zostanie zresetowany.
ImportElasticNoPagesInBundle: Nie znaleziono stron w przesłanych danych
ImportInvalidPassword: Niepoprawne hasło
ImportRatingsOneRating: 1 ocena
ImportRatingsRatings: Oceny
ImportRolesPermissionDenied: Odmowa dostępu
ImportSearchNoCategoriesUploaded: Nie przesłano pliku XML kategorii
ImportSearchUnknownTopicLink: *** nieznane łącze tematu ***
ImportUsersCaptchaError: Nieprawidłowy kod reCAPTCHA 
ImportUsersCaptchaParseError: Błąd reCAPTCHA
ImportUsersEmailFieldError: Nie znaleziono pola adresu e-mail.
ImportUsersFldEmail: E-mail
ImportUsersFldFirstName: Imię
ImportUsersFldLastName: Nazwisko
ImportUsersFldPassword: Hasło
ImportUsersFldReenterPass: Wprowadź ponownie hasło
ImportUsersInvalidPass: Nieprawidłowe hasło: wybrane hasło musi składać się z przynajmniej 8 znaków i zawierać przynajmniej 1 wielką literę, 1 małą literę, 1 znak specjalny i 1 cyfrę.
LoggedInAs email@Text: Zalogowano jako #{email}.
Manuals: Instrukcje
PDFPage: Strona
ProductDocumentationSplashTitle: Dokumentacja produktu 
PublishHowto: Opublikuj
ResultsPerPage: Liczba wyników na stronę
ResultsPerPageShow: Pokaż xx na stronę
Search: Przeszukaj dokumentację produktu
SearchContent: Przeszukaj tę zawartość
SearchHome: Przeszukaj dokumentację produktu
ShowTOC: Pokaż spis treści
SSOLoginParamError: Wystąpił błąd z parametrami logowania SSO
SSOLoginTryAgain: Spróbuj zalogować się ponownie za pomocą
SwitchLang: Zmień język
TemplaesBundlesTitle: Biblioteka z dokumentacją
TemplateAddHelperCancel: Anuluj
TemplateAddHelperSave: Zapisz
TemplateAddHelperSaveAndClose: Zapisz i zamknij
TemplateAddUserAddUser: Dodaj użytkownika
TemplateAddUserCancel: Anuluj
TemplateAddUserPasswordMessage: Hasło musi składać się z przynajmniej 8 znaków i zawierać przynajmniej 1 wielką literę, 1 małą literę, 1 znak specjalny i 1 cyfrę.
TemplateAdminArticleManagement: Zarządzanie artykułami
TemplateAdminContentRoleGroups: Grupy roli zawartości
TemplateAdminCSHConfigFile: Pobierz lub zaktualizuj plik konfiguracji CSH
TemplateAdminElasticReindex: Przebuduj indeks wyszukiwania
TemplateAdminExportComments: Eksportuj komentarze
TemplateAdminExportRatings: Eksportuj oceny
TemplateAdminManageManuals: Zarządzaj instrukcjami
TemplateAdminManageResourceManuals: Zarządzaj pakietami zasobów
TemplateAdminResourceIdCsv: Pobierz plik Excel z identyfikatorami zasobów
TemplateAdminSitemap: Zarządzaj mapą witryny
TemplateAdminSubjectSchemeLocalization: Zarządzaj lokalizacją schematu tematu
TemplateAdminTitle: Administracja
TemplateAdminUploadCategoryXML: Zarządzaj plikiem XML kategorii
TemplateAdminUploadCategoryXml: Prześlij nowy plik XML kategorii
TemplateAdminUploadNewLangFile: Prześlij nowy pliku kodu języka domyślnego
TemplateAdminUploadSubjectScheme: Zarządzaj schematem tematu
TemplateAdminUserGroups: Grupy użytkowników
TemplateAdminUserManagement: Zarządzanie użytkownikami
TemplateAdminUserRoles: Role użytkowników
TemplateBundlePageCollapse: Zwiń
TemplateBundlePageCollapseTooltip: Zwiń wszystkie tytuły
TemplateBundlePageComments: Komentarze
TemplateBundlePageContents: Zawartość
TemplateBundlePageExpand: Rozwiń
TemplateBundlePageExpandTooltip: Rozwiń spis treści
TemplateBundlePageFeedback: Opinia
TemplateBundlePageFeedbackThankYou: Dziękujemy! Twoje komentarze zostały wysłane. 
TemplateBundlePageFeedbackTooltip: Wyślij opinię
TemplateBundlePageFilterTitle: Wybierz jedną lub więcej opcji
TemplateBundlePageNext: Następny
TemplateBundlePageNextTopicTooltip: Przejdź do następnego tematu
TemplateBundlePageNo: Nie
TemplateBundlePagePrevious: Poprzedni 
TemplateBundlePagePrevTopicTooltip: Przejdź do poprzedniego tematu
TemplateBundlePagePrint: Drukuj
TemplateBundlePagePrintTooltip: Wydrukuj temat
TemplateBundlePagePrivacy: Aby chronić swoją prywatność, nie podawaj informacji kontaktowych w treści swojej opinii. Przejrzyj nasze zasady zachowania prywatności.
TemplateBundlePageProvideFeedbackTooltip: Prześlij opinię
TemplateBundlePageSaveAsPDF: Zapisz jako plik PDF
TemplateBundlePageSavePDFTooltip: Zapisz jako plik PDF
TemplateBundlePageSaveSelectedTopic: Zapisz wybrany temat
TemplateBundlePageSaveSelectedTopicAndSubtopics: Zapisz wybrany temat i podtematy
TemplateBundlePageSeeAlso: Patrz także
TemplateBundlePageSend: Wyślij
TemplateBundlePageSendLink: Wyślij
TemplateBundlePageSendLinkTooltip: Wyślij łącze do tematu
TemplateBundlePageSubmit: Wyślij
TemplateBundlePageWasThisInformationHelpful: Czy te informacje były pomocne?
TemplateBundlePageYEs: Tak
TemplateBundlesDeleteLanguage: Usuń język
TemplateBundlesDeleteManual: Usuń instrukcję
TemplateBundlesDownload: Pobierz zestaw
TemplateBundlesDownloadClassification: Pobierz plik XML klasyfikacji
TemplateBundlesHiddenBundle: Ukryta instrukcja
TemplateBundlesSearchManuals: Przeszukaj instrukcje
TemplateBundlesUploadClassification: Prześlij plik XML klasyfikacji
TemplateClassificationForManual: Dla instrukcji
TemplateClassificationUploadClassificationMap: Prześlij plik XML mapy klasyfikacji
TemplateClassificationWarnReindex: UWAGA: Przesłanie mapy klasyfikacji spowoduje wykonanie ponownego indeksowania całej witryny. Może to potrwać kilka minut.
TemplateContentRolesCRGroups: Grupy roli zawartości
TemplateContentRolesDefineNewCR: Zdefiniuj nową rolę zawartości
TemplateDefaultLayoutAdministration: Administracja
TemplateDefaultLayoutArticles: Artykuły
TemplateDefaultLayoutBrowseDocumentation: Przeglądaj
TemplateDefaultLayoutDocumentation: Biblioteka z dokumentacją
TemplateDefaultLayoutHome: Strona główna
TemplateDefaultLayoutLanguages: United States - English
TemplateDefaultLayoutLinksCareers: Możliwości kariery
TemplateDefaultLayoutLinksContactUs: Skontaktuj się z nami
TemplateDefaultLayoutLinksIntelCorp: © Intel Corporation
TemplateDefaultLayoutLinksLegalContractsandTerms: Umowy prawne i postanowienia
TemplateDefaultLayoutLinksLegalNotices: Uwagi prawne  
TemplateDefaultLayoutLinksSiteMap: Mapa witryny
TemplateDefaultLayoutLinksWebsiteFeedback: Uwagi dotyczące witryny sieci Web
TemplateDefaultLayoutLogout: Wyloguj
TemplateDefaultLayoutProfile: Profil
TemplateDefaultLayoutVideos: Nagrania wideo
TemplateFilterCurrentPublication: Bieżąca publikacja
TemplateRequestResetPasswordEmail: E-mail
TemplateRequestResetPasswordSubmit: Zażądaj wiadomości e-mail umożliwiającej resetowanie hasła
TemplateSearchCurrentPublication name@Text: Bieżące wyszukiwanie jest ograniczone do publikacji '#{name}'
TemplateSearchPageClearTooltip: Wyczyść filtry
TemplateSearchPageFirstPageTooltip: Przejdź do pierwszej strony
TemplateSearchPageLastPageTooltip: Przejdź do ostatniej strony
TemplateSearchPageNextPageTooltip: Przejście do następnej strony
TemplateSearchPagePrevPageTooltip: Przejście do poprzedniej strony
TemplateSearchPublicationTitle: Publikacja
TemplateSearchSortbyCreatedAsc: Data utworzenia — rosnąco
TemplateSearchSortbyCreatedDec: Data utworzenia — malejąco
TemplateSearchSortbyScore: Wynik
TemplateSearchSortbyUpdatedAsc: Data dodania — rosnąco
TemplateSearchSortbyUpdatedDec: Data dodania — malejąco
TemplateSearchSortbyViews: Liczba wyświetleń
TemplatesSearchPageClear: Wyczyść
TemplatesSearchPageCurrentResults: Wyniki xx-yy z zzz
TemplatesSearchPageRefilneResults: Zawęź wyniki
TemplatesSearchPageResultUpdated: Zaktualizowano
TemplateUploadSitemapDisable: Wyłącz mapę witryny
TemplateUploadSitemapDisabled: Mapa witryny została wyłączona
TemplateUploadSitemapDisabledWord: Wyłączona
TemplateUploadSitemapDownloadSitemap: Pobierz plik sitemap.xml
TemplateUploadSitemapEnable: Włącz mapę witryny
TemplateUploadSitemapEnabled: Mapa witryny została włączona
TemplateUploadSitemapEnabledWord: Włączona
TemplateUploadSitemapLegend: Prześlij plik sitemap.xml
TemplateUploadSitemapStatus sts@Text: Mapa witryny jest #{sts}
TemplTemplateBundlePageProvideFeedbackTooltip: Wyślij opinię
TextPass txt@Text: #{txt}
Upload: Prześlij
UploadLink: Prześlij publikację
YesodAuthStormPathSSOErrorOccured: Wystąpił błąd
YesodAuthStormPathSSOLoginParamError: Wystąpił błąd z parametrami logowania SSO
YesodAuthStormPathSSOLoginTryAgain: Spróbuj zalogować się ponownie za pomocą