AdvancedSearch: Расширенный поиск 
AdvancedSearchTooltip: Выбрать фильтры содержимого
BreadcrumbsProductDocumentationHome: Домашняя страница документации по продукту
BreadcrumbsSearch: Поиск
Cancel: Отмена
Close: Закрыть
DeleteText: Удалить
ErrorOccured: Возникла ошибка
FilterUsers: Фильтровать пользователей:
FoundationLoginOnly: Выполнить вход
FoundationLoginRegister: Выполнить вход / зарегистрироваться
HandlerAdminOnlyAdmin: Доступ запрещен
HandlerBundlePageAltCSHResult: Найдена дополнительная тема CSH
HandlerCategoriesCategoryXMLFileUploaded: Выгружен XML-файл категорий
HandlerClassificationUpdated: Карта классификации обновлена
HandlerClassificationXMLFile: Карта классификации обновлена
HandlerCommentsComments: коммент.
HandlerCommentsOneComment: 1 комментарий
HandlerCommentsPostedCommentOn: опубликовал(-а) комментарий на тему:
HandlerContentRolesAreYouSureDelete: Удалить эту роль содержимого?
HandlerContentRolesCRDeleted: Роль содержимого удалена
HandlerContentRolesErrorDeleting: Возникла ошибка. Роль содержимого не была удалена.
HandlerCshAlternateCSHTopicFound: Найдена дополнительная тема CSH
HandlerCshCSHRulesUpdated: Правила CSH обновлены
HandlerCshInvalidAliases: Недопустимые ключи псевдонима, обнаруженные в URL-адресе CSH
HandlerCshInvalidCSHRulesFile: Недопустимый файл правил CSH
HandlerCshNewCshFile: Выгрузить новый файл конфигурации CSH
HandlerCshReservedAliasesUsed: Резервные псевдонимы, используемые в файле конфигурации CSH
HandlerCustomError400H2: 400
HandlerCustomError400H3: Неверный запрос
HandlerCustomError401H2: 401
HandlerCustomError401H3: Неавторизованный запрос
HandlerCustomError403H2: 403
HandlerCustomError403H3: Доступ запрещен
HandlerCustomError404H2: 404
HandlerCustomError404H3: Ресурс не найден
HandlerCustomError405H2: 405
HandlerCustomError405H3: Недопустимый метод
HandlerCustomError500H2: 500
HandlerCustomError500H3: Внутренняя ошибка сервера
HandlerFontoDocumentSaved: Документ сохранен
HandlerFontoErrorGeneratingUUID: Ошибка создания идентификатора UUID
HandlerFontoErrorParsingID: Ошибка анализа идентификатора
HandlerFontoErrorParsingXML: Ошибка анализа XML-файла
HandlerFontoErrorParsingXMLToDocument: Ошибка анализа XML-файла для документа
HandlerFontoNoFileFound: Файл не найден
HandlerFontoNoIDFound: Идентификатор не найден
HandlerFontoUntitledFromCursor: Без названия – из курсора
HandlerGroupsErrorReadingGroupID: Ошибка считывания идентификатора группы
HandlerGroupsGroupUpdated: Группа обновлена
HandlerGroupsMustUseUniqueGroupName: Необходимо использовать уникальное имя группы
HandlerGroupsNoGroupNameFound: Имя группы не найдено
HandlerGroupsUnableAssignRole: Не удается назначить роль
HandlerHowtoContent: Содержимое
HandlerHowtoDeleted: Статья удалена
HandlerHowtoInsufficientPermissions: Нет разрешений на редактирование этой статьи
HandlerHowtoSaved: Сохранено
HandlerHowtoTitle: Заголовок
HandlerHtmlEmptyMyDocs: Очистить папку "Мои документы"
HandlerLangDefaultLanguageCodeFileUpdated: Файл с кодом языка по умолчанию обновлен
HandlerLangNewLangFile: Выгрузить новый файл с кодом языка по умолчанию
HandlerMyPubSourcePublication: Исходная публикация
HandlerProfileDisplayName: Отображаемое имя
HandlerProfileScreenName: Имя пользователя
HandlerProfileUpdated: Профиль обновлен
HandlerProfileUsernameInUse: Имя пользователя уже существует
HandlerRatingsInvalidRating: Недопустимый рейтинг
HandlerRatingsRatingRecorded: Ваш рейтинг записан
HandlerRatingsRatingUpdated: Ваш рейтинг обновлен
HandlerRolesErrorReadingRoleID: Ошибка считывания идентификатора роли
HandlerRolesMustUseUniqueRoleName: Используйте уникальное имя роли
HandlerRolesNoRoleNameFound: Имя роли не найдено
HandlerRolesNotEnoughAdminUsersRemaining: Не удается назначить пользователей
HandlerRolesSelectedPermissionsLessThenDefault: Не удается назначить разрешения: уровень выбранных разрешений ниже, чем уровень набора разрешений по умолчанию
HandlerSearchAllResults: Все результаты
HandlerSearchNoResults: Нет результатов
HandlerSearchOneResult: Один результат
HandlerSitemapFile: Файл карты сайта
HandlerSitemapFileUploaded: Карта сайта успешно обновлена.
HandlerSubjectSchemeInvalidSubjectSchemeLocalizationFile: Недопустимый файл локализации тематической схемы
HandlerSubjectSchemeLangDeleted lang@Text: #{lang} Файл локализации удален
HandlerSubjectSchemeLangsAvailable: Доступные языки
HandlerSubjectSchemeLangsDeleteConfirm: Удалить файл локализации? 
HandlerSubjectSchemeLangsDeleteError: Ошибка при удалении файла локализации.
HandlerSubjectSchemeLangsNewFile: Передать новый файл локализации тематической схемы
HandlerSubjectSchemeLangUpdated lang@Text: #{lang} Файл локализации обновлен
HandlerSubjectSchemeLangUploaded lang@Text: #{lang} Файл локализации выгружен 
HandlerSubjectSchemeProblemOccurredWhileUploadingSubjectScheme: При выгрузке тематической схемы возникла проблема.
HandlerSubjectSchemeSubjectSchemeUploadedSuccessfully: Тематическая схема успешно выгружена
HandlerSubjectSchemeUnknownLanguageCode: Неизвестный код языка
HandlerSubjectSchemeUpdated: Тематическая схема обновлена
HandlerSubjectSchemeXMLFile: XML-файл тематической схемы
HandlerUploadBundleBundle: пакет
HandlerUploadBundleDeleteError x@Text: Ошибка удаления #{x}
HandlerUploadBundleDeleteSuccess x@Text: Удаление #{x} выполнено успешно
HandlerUploadBundleError: Ошибка
HandlerUploadBundleErrorPleaseUpdateSuiteBundleVersion: Ошибка: обновите версию пакета
HandlerUploadBundleNoContentToDelete x@Text: В #{x} нет содержимого для удаления 
HandlerUploadBundleOneBundleError: Ошибка заполнения выгруженного пакета
HandlerUploadBundlePublicationUploadedSuccessfully: Публикация успешно выгружена
HandlerUploadBundleSheaf: sheaf
HandlerUsersAddedSuccess: Пользователь успешно добавлен
HandlerUsersBadEmail: Адрес электронной почты не зарегистрирован
HandlerUsersCRCreated: Группа ролей содержимого создана
HandlerUsersCRGroupNameInUse: Имя роли содержимого уже используется
HandlerUsersCRSetGroupName: Задайте имя для этой группы ролей содержимого
HandlerUsersCRUpdated: Группа ролей содержимого обновлена
HandlerUsersDefineCR: Определить новую группу ролей содержимого
HandlerUsersDeleteSuccess: Пользователь успешно удален
HandlerUsersEmailError: Ошибка при отправке сообщения электронной почты со ссылкой для сброса пароля
HandlerUsersInvalidToken: Недопустимый токен
HandlerUsersNoResetToken: Токен сброса отсутствует
HandlerUsersNoRoleIdFound: Идентификатор роли не найден
HandlerUsersPasswordEmailSent: Отправлено сообщение электронной почты со ссылкой для сброса пароля
HandlerUsersRegisterSuccess: Пользователь успешно зарегистрирован
HandlerUsersResetPasswordError: Ошибка при сбросе пароля
HandlerUsersRolesUpdated: Роли пользователя обновлены
HandlerUsersUnableToAssignUserPermissionRole: Не удается назначить роль с разрешением пользователя
HandlerUsersUnknownError: Неизвестная ошибка
HideTOC: Скрыть содержание
ImportAddHelperProblemRunningAddHelper: При запуске addHelper возникла проблема
ImportBundlesTooManyTopics num@Int: Максимальное количество тем для публикации: #{show num}. Выберите меньше тем и повторите попытку.
ImportElasticAnalyzerError: - Примечание: ошибка пользовательского анализатора. Подробные сведения см. в журнале. Используется анализатор по умолчанию. 
ImportElasticErrorRebuilding: Ошибка перестроения индекса. Подробные сведения см. в журнале.
ImportElasticErrorUpdating: Ошибка обновления индекса. Подробные сведения см. в журнале.
ImportElasticIndexRebuilt x@Text: Индекс успешно перестроен #{x}
ImportElasticIndexUpdated x@Text: Индекс успешно обновлен #{x}
ImportElasticNoPagesFound: В базе данных не найдено ни одной страницы – индекс сброшен.
ImportElasticNoPagesInBundle: В выгруженных файлах не найдено ни одной страницы
ImportInvalidPassword: Недопустимый пароль
ImportRatingsOneRating: 1 рейтинг
ImportRatingsRatings: Рейтинги
ImportRolesPermissionDenied: В разрешении отказано
ImportSearchNoCategoriesUploaded: Нет выгруженных XML-файлов категорий
ImportSearchUnknownTopicLink: *** ссылка на неизвестную тему ***
ImportUsersCaptchaError: В поле reCAPTCHA введены недопустимые символы 
ImportUsersCaptchaParseError: Ошибка reCAPTCHA
ImportUsersEmailFieldError: Поле адреса электронной почты не найдено.
ImportUsersFldEmail: Адрес электронной почты
ImportUsersFldFirstName: Имя
ImportUsersFldLastName: Фамилия
ImportUsersFldPassword: Пароль
ImportUsersFldReenterPass: Подтверждение пароля
ImportUsersInvalidPass: Недопустимый пароль: выбранный пароль должен содержать не менее 8 символов, включая как минимум 1 букву в верхнем и 1 в нижнем регистрах, 1 специальный символ и 1 цифру.
LoggedInAs email@Text: Вы вошли как #{email}.
Manuals: Руководства
PDFPage: Страница
ProductDocumentationSplashTitle: Документация по продукту 
PublishHowto: Публиковать
ResultsPerPage: Количество результатов на странице
ResultsPerPageShow: Отображать xx на странице
Search: Поиск в документации по продукту
SearchContent: Поиск в этом содержимом
SearchHome: Поиск в документации по продукту
ShowTOC: Показать содержание
SSOLoginParamError: Возникла ошибка, связанная с параметрами входа SSO
SSOLoginTryAgain: Повторите попытку входа с
SwitchLang: Изменить язык
TemplaesBundlesTitle: Библиотека документов
TemplateAddHelperCancel: Отмена
TemplateAddHelperSave: Сохранить
TemplateAddHelperSaveAndClose: Сохранить и закрыть
TemplateAddUserAddUser: Добавить пользователя
TemplateAddUserCancel: Отмена
TemplateAddUserPasswordMessage: Пароль должен содержать не менее 8 символов, включая как минимум 1 букву в верхнем и 1 в нижнем регистрах, 1 специальный символ и 1 цифру.
TemplateAdminArticleManagement: Управление статьями
TemplateAdminContentRoleGroups: Группы ролей содержимого
TemplateAdminCSHConfigFile: Загрузить или обновить файл конфигурации CSH
TemplateAdminElasticReindex: Перестроить поисковый индекс
TemplateAdminExportComments: Экспортировать комментарии
TemplateAdminExportRatings: Рейтинги экспорта
TemplateAdminManageManuals: Управление руководствами
TemplateAdminManageResourceManuals: Управление пакетами ресурсов
TemplateAdminResourceIdCsv: Загрузить Excel-файл ResourceIds
TemplateAdminSitemap: Управление картой сайта
TemplateAdminSubjectSchemeLocalization: Управление локализацией тематической схемы
TemplateAdminTitle: Администрирование
TemplateAdminUploadCategoryXML: Управление XML-файлом категорий
TemplateAdminUploadCategoryXml: Выгрузить новый XML-файл категорий
TemplateAdminUploadNewLangFile: Выгрузить новый файл с кодом языка по умолчанию
TemplateAdminUploadSubjectScheme: Управление тематической схемой
TemplateAdminUserGroups: Группы пользователей
TemplateAdminUserManagement: Управление пользователями
TemplateAdminUserRoles: Роли пользователя
TemplateBundlePageCollapse: Свернуть
TemplateBundlePageCollapseTooltip: Свернуть все заголовки
TemplateBundlePageComments: Комментарии
TemplateBundlePageContents: Содержание
TemplateBundlePageExpand: Развернуть
TemplateBundlePageExpandTooltip: Развернуть содержание
TemplateBundlePageFeedback: Обратная связь
TemplateBundlePageFeedbackThankYou: Спасибо! Ваши комментарии отправлены. 
TemplateBundlePageFeedbackTooltip: Отправить отзыв
TemplateBundlePageFilterTitle: Выберите один или несколько вариантов
TemplateBundlePageNext: Далее
TemplateBundlePageNextTopicTooltip: Перейти к следующей теме
TemplateBundlePageNo: Нет
TemplateBundlePagePrevious: Назад 
TemplateBundlePagePrevTopicTooltip: Перейти к предыдущей теме
TemplateBundlePagePrint: Печать
TemplateBundlePagePrintTooltip: Распечатать тему
TemplateBundlePagePrivacy: Чтобы сохранить конфиденциальность, не указывайте контактные данные в вашем отзыве. Ознакомьтесь с нашей политикой конфиденциальности.
TemplateBundlePageProvideFeedbackTooltip: Предоставить отзыв
TemplateBundlePageSaveAsPDF: Сохранить в формате PDF
TemplateBundlePageSavePDFTooltip: Сохранить в формате PDF
TemplateBundlePageSaveSelectedTopic: Сохранить выбранную тему
TemplateBundlePageSaveSelectedTopicAndSubtopics: Сохранить выбранную тему и подтемы
TemplateBundlePageSeeAlso: См. также
TemplateBundlePageSend: Отправить
TemplateBundlePageSendLink: Отправить
TemplateBundlePageSendLinkTooltip: Отправить ссылку на тему
TemplateBundlePageSubmit: Отправить
TemplateBundlePageWasThisInformationHelpful: Была ли эта информация полезной?
TemplateBundlePageYEs: Да
TemplateBundlesDeleteLanguage: Удалить язык
TemplateBundlesDeleteManual: Удалить руководство
TemplateBundlesDownload: Загрузить пакет
TemplateBundlesDownloadClassification: Загрузить XML-файл классификации
TemplateBundlesHiddenBundle: Скрытое руководство
TemplateBundlesSearchManuals: Искать руководства
TemplateBundlesUploadClassification: Выгрузить XML-файл классификации
TemplateClassificationForManual: Вручную
TemplateClassificationUploadClassificationMap: Выгрузить XML-файл карты классификации
TemplateClassificationWarnReindex: ПРИМЕЧАНИЕ. При выгрузке карты классификации будет выполнена повторная индексация всего сайта. Это может занять несколько минут.
TemplateContentRolesCRGroups: Группы ролей содержимого
TemplateContentRolesDefineNewCR: Определить новую роль содержимого
TemplateDefaultLayoutAdministration: Администрирование
TemplateDefaultLayoutArticles: Статьи
TemplateDefaultLayoutBrowseDocumentation: Обзор
TemplateDefaultLayoutDocumentation: Библиотека документов
TemplateDefaultLayoutHome: Домашняя
TemplateDefaultLayoutLanguages: United States - English
TemplateDefaultLayoutLinksCareers: Вакансии
TemplateDefaultLayoutLinksContactUs: Связаться с нами
TemplateDefaultLayoutLinksIntelCorp: © Intel Corporation
TemplateDefaultLayoutLinksLegalContractsandTerms: Законные контракты и условия
TemplateDefaultLayoutLinksLegalNotices: Правовое уведомление  
TemplateDefaultLayoutLinksSiteMap: Карта сайта
TemplateDefaultLayoutLinksWebsiteFeedback: Обратная связь через веб-сайт
TemplateDefaultLayoutLogout: Выйти
TemplateDefaultLayoutProfile: Профиль
TemplateDefaultLayoutVideos: Видео
TemplateFilterCurrentPublication: Текущая публикация
TemplateRequestResetPasswordEmail: Сообщение электронной почты
TemplateRequestResetPasswordSubmit: Запросить электронное сообщение со ссылкой для сброса пароля
TemplateSearchCurrentPublication name@Text: Текущий поиск ограничен публикацией "#{name}"
TemplateSearchPageClearTooltip: Убрать фильтры
TemplateSearchPageFirstPageTooltip: Перейти к первой странице
TemplateSearchPageLastPageTooltip: Перейти к последней странице
TemplateSearchPageNextPageTooltip: Перейти к следующей странице
TemplateSearchPagePrevPageTooltip: Перейти к предыдущей странице
TemplateSearchPublicationTitle: Публикация
TemplateSearchSortbyCreatedAsc: Дата создания – по возрастанию
TemplateSearchSortbyCreatedDec: Дата создания – по убыванию
TemplateSearchSortbyScore: Оценка
TemplateSearchSortbyUpdatedAsc: Дата добавления – по возрастанию
TemplateSearchSortbyUpdatedDec: Дата добавления – по убыванию
TemplateSearchSortbyViews: Число просмотров
TemplatesSearchPageClear: Очистить
TemplatesSearchPageCurrentResults: Результаты xx-yy из zzz
TemplatesSearchPageRefilneResults: Уточнить результаты
TemplatesSearchPageResultUpdated: Обновлено
TemplateUploadSitemapDisable: Отключить карту сайта
TemplateUploadSitemapDisabled: Карта сайта отключена
TemplateUploadSitemapDisabledWord: Отключена
TemplateUploadSitemapDownloadSitemap: Загрузить файл sitemap.xml
TemplateUploadSitemapEnable: Включить карту сайта
TemplateUploadSitemapEnabled: Карта сайта включена
TemplateUploadSitemapEnabledWord: Включена
TemplateUploadSitemapLegend: Выгрузить файл sitemap.xml
TemplateUploadSitemapStatus sts@Text: Состояние карты сайта: #{sts}
TemplTemplateBundlePageProvideFeedbackTooltip: Отправить отзыв
TextPass txt@Text: #{txt}
Upload: Выгрузить
UploadLink: Отправить публикацию
YesodAuthStormPathSSOErrorOccured: Возникла ошибка
YesodAuthStormPathSSOLoginParamError: Возникла ошибка, связанная с параметрами входа SSO
YesodAuthStormPathSSOLoginTryAgain: Повторите попытку входа с